term	valence	subjectivity
abase	negative	strongsubj
abasement	negative	strongsubj
abash	negative	strongsubj
aberration	negative	strongsubj
abhor	negative	strongsubj
abhorred	negative	strongsubj
abhorrence	negative	strongsubj
abhorrent	negative	strongsubj
abhorrently	negative	strongsubj
abhors	negative	strongsubj
abidance	positive	strongsubj
abide	positive	strongsubj
abject	negative	strongsubj
abjectly	negative	strongsubj
abominable	negative	strongsubj
abominably	negative	strongsubj
abominate	negative	strongsubj
abomination	negative	strongsubj
abrasive	negative	strongsubj
abscond	negative	strongsubj
absent-minded	negative	strongsubj
absolve	positive	strongsubj
absolute	neutral	strongsubj
absolutely	neutral	strongsubj
absurd	negative	strongsubj
absurdity	negative	strongsubj
absurdly	negative	strongsubj
absurdness	negative	strongsubj
abuse	negative	strongsubj
abusive	negative	strongsubj
abysmal	negative	strongsubj
abysmally	negative	strongsubj
abyss	negative	strongsubj
accede	positive	strongsubj
accentuate	neutral	strongsubj
acclaim	positive	strongsubj
acclaimed	positive	strongsubj
acclamation	positive	strongsubj
accolade	positive	strongsubj
accolades	positive	strongsubj
accursed	negative	strongsubj
accusation	negative	strongsubj
accusations	negative	strongsubj
accuse	negative	strongsubj
accuses	negative	strongsubj
accusing	negative	strongsubj
accusingly	negative	strongsubj
acerbate	negative	strongsubj
acerbic	negative	strongsubj
acerbically	negative	strongsubj
ache	negative	strongsubj
acrid	negative	strongsubj
acridly	negative	strongsubj
acridness	negative	strongsubj
acrimonious	negative	strongsubj
acrimoniously	negative	strongsubj
acrimony	negative	strongsubj
activist	neutral	strongsubj
actual	neutral	strongsubj
actuality	neutral	strongsubj
actually	neutral	strongsubj
acumen	positive	strongsubj
adamant	negative	strongsubj
adamantly	negative	strongsubj
admirable	positive	strongsubj
admirer	positive	strongsubj
admirably	positive	strongsubj
admiration	positive	strongsubj
admire	positive	strongsubj
admiring	positive	strongsubj
admiringly	positive	strongsubj
admit	positive	strongsubj
admittedly	positive	strongsubj
admonish	negative	strongsubj
admonisher	negative	strongsubj
admonishingly	negative	strongsubj
admonishment	negative	strongsubj
admonition	negative	strongsubj
adolescents	neutral	strongsubj
adorable	positive	strongsubj
adore	positive	strongsubj
adored	positive	strongsubj
adorer	positive	strongsubj
adoring	positive	strongsubj
adoringly	positive	strongsubj
adroit	positive	strongsubj
adroitly	positive	strongsubj
adulate	positive	strongsubj
adulation	positive	strongsubj
adulatory	positive	strongsubj
adulterate	negative	strongsubj
adulterated	negative	strongsubj
adulteration	negative	strongsubj
advantageous	positive	strongsubj
adventuresome	positive	strongsubj
adventurism	positive	strongsubj
adversity	negative	strongsubj
advocate	positive	strongsubj
advocacy	positive	strongsubj
affable	positive	strongsubj
affected	neutral	strongsubj
affection	positive	strongsubj
affectionate	positive	strongsubj
affirm	positive	strongsubj
affirmation	positive	strongsubj
afflictive	negative	strongsubj
affront	negative	strongsubj
afraid	negative	strongsubj
aggravate	negative	strongsubj
aggravating	negative	strongsubj
aggravation	negative	strongsubj
aggression	negative	strongsubj
aggressive	negative	strongsubj
aggressiveness	negative	strongsubj
aggressor	negative	strongsubj
aggrieve	negative	strongsubj
aggrieved	negative	strongsubj
aghast	negative	strongsubj
agitate	negative	strongsubj
agitated	negative	strongsubj
agitation	negative	strongsubj
agitator	negative	strongsubj
agonies	negative	strongsubj
agonize	negative	strongsubj
agonizing	negative	strongsubj
agonizingly	negative	strongsubj
agony	negative	strongsubj
agree	positive	strongsubj
agreeability	positive	strongsubj
agreeable	positive	strongsubj
agreeableness	positive	strongsubj
agreeably	positive	strongsubj
aha	neutral	strongsubj
aimless	negative	strongsubj
air	neutral	strongsubj
alarmed	negative	strongsubj
alarming	negative	strongsubj
alarmingly	negative	strongsubj
alas	negative	strongsubj
allay	positive	strongsubj
allegation	negative	strongsubj
allegations	negative	strongsubj
allegorize	neutral	strongsubj
alliance	neutral	strongsubj
alliances	neutral	strongsubj
allure	positive	strongsubj
alluring	positive	strongsubj
alluringly	positive	strongsubj
allusion	neutral	strongsubj
allusions	neutral	strongsubj
ally	positive	strongsubj
almighty	positive	strongsubj
aloof	negative	strongsubj
altogether	neutral	strongsubj
altruist	positive	strongsubj
altruistic	positive	strongsubj
altruistically	positive	strongsubj
amaze	positive	strongsubj
amazed	positive	strongsubj
amazement	positive	strongsubj
amazing	positive	strongsubj
amazingly	positive	strongsubj
ambiguous	negative	strongsubj
ambiguity	negative	strongsubj
ambivalence	negative	strongsubj
ambivalent	negative	strongsubj
ameliorate	positive	strongsubj
amenable	positive	strongsubj
amiability	positive	strongsubj
amiabily	positive	strongsubj
amiable	positive	strongsubj
amicability	positive	strongsubj
amicable	positive	strongsubj
amicably	positive	strongsubj
amiss	negative	strongsubj
amour	positive	strongsubj
amuse	positive	strongsubj
amusement	positive	strongsubj
amusing	positive	strongsubj
amusingly	positive	strongsubj
anarchism	negative	strongsubj
anarchist	negative	strongsubj
anarchistic	negative	strongsubj
anarchy	negative	strongsubj
angelic	positive	strongsubj
anger	negative	strongsubj
angrily	negative	strongsubj
angriness	negative	strongsubj
angry	negative	strongsubj
anguish	negative	strongsubj
annihilate	negative	strongsubj
annihilation	negative	strongsubj
animosity	negative	strongsubj
annoy	negative	strongsubj
annoyance	negative	strongsubj
annoyed	negative	strongsubj
annoying	negative	strongsubj
annoyingly	negative	strongsubj
antagonism	negative	strongsubj
antagonistic	negative	strongsubj
antagonize	negative	strongsubj
anti-	negative	strongsubj
anti-American	negative	strongsubj
anti-Israeli	negative	strongsubj
anti-Semites	negative	strongsubj
anti-US	negative	strongsubj
anti-occupation	negative	strongsubj
anti-proliferation	negative	strongsubj
anti-social	negative	strongsubj
anti-white	negative	strongsubj
antipathy	negative	strongsubj
antiquated	negative	strongsubj
antithetical	negative	strongsubj
anxieties	negative	strongsubj
anxiety	negative	strongsubj
anxious	negative	strongsubj
anxiously	negative	strongsubj
anxiousness	negative	strongsubj
anyhow	neutral	strongsubj
anyway	neutral	strongsubj
anyways	neutral	strongsubj
apathetic	negative	strongsubj
apathetically	negative	strongsubj
apathy	negative	strongsubj
ape	negative	strongsubj
apocalypse	negative	strongsubj
apocalyptic	negative	strongsubj
apologist	negative	strongsubj
apologists	negative	strongsubj
apostle	positive	strongsubj
apotheosis	positive	strongsubj
appal	negative	strongsubj
appall	negative	strongsubj
appalled	negative	strongsubj
appalling	negative	strongsubj
appallingly	negative	strongsubj
appealing	positive	strongsubj
applaud	positive	strongsubj
appreciate	positive	strongsubj
appreciation	positive	strongsubj
appreciative	positive	strongsubj
appreciatively	positive	strongsubj
appreciativeness	positive	strongsubj
apprehension	negative	strongsubj
apprehensions	negative	strongsubj
apprehensive	negative	strongsubj
apprehensively	negative	strongsubj
arbitrary	negative	strongsubj
arcane	negative	strongsubj
archaic	negative	strongsubj
ardent	positive	strongsubj
ardently	positive	strongsubj
ardor	positive	strongsubj
arduous	negative	strongsubj
arduously	negative	strongsubj
argue	negative	strongsubj
argumentative	negative	strongsubj
arousal	positive	strongsubj
arouse	positive	strongsubj
arousing	positive	strongsubj
arresting	positive	strongsubj
arrogance	negative	strongsubj
arrogant	negative	strongsubj
arrogantly	negative	strongsubj
articulate	positive	strongsubj
ascendant	positive	strongsubj
ascertainable	positive	strongsubj
ashamed	negative	strongsubj
asinine	negative	strongsubj
asininely	negative	strongsubj
asinininity	negative	strongsubj
askance	negative	strongsubj
asperse	negative	strongsubj
aspersion	negative	strongsubj
aspersions	negative	strongsubj
aspiration	positive	strongsubj
aspirations	positive	strongsubj
aspire	positive	strongsubj
assassin	negative	strongsubj
assent	positive	strongsubj
assertions	positive	strongsubj
assess	neutral	strongsubj
assiduous	positive	strongsubj
assiduously	positive	strongsubj
assure	positive	strongsubj
assuredly	positive	strongsubj
astonish	positive	strongsubj
astonished	positive	strongsubj
astonishing	positive	strongsubj
astonishingly	positive	strongsubj
astonishment	positive	strongsubj
astound	positive	strongsubj
astounded	positive	strongsubj
astounding	positive	strongsubj
astoundingly	positive	strongsubj
astronomic	neutral	strongsubj
astronomical	neutral	strongsubj
astronomically	neutral	strongsubj
astute	positive	strongsubj
astutely	positive	strongsubj
asunder	negative	strongsubj
atrocious	negative	strongsubj
atrocities	negative	strongsubj
atrocity	negative	strongsubj
atrophy	negative	strongsubj
attentive	positive	strongsubj
attest	positive	strongsubj
attitude	neutral	strongsubj
attraction	positive	strongsubj
attractive	positive	strongsubj
attractively	positive	strongsubj
audacious	negative	strongsubj
audaciously	negative	strongsubj
audaciousness	negative	strongsubj
audacity	negative	strongsubj
auspicious	positive	strongsubj
austere	negative	strongsubj
autocrat	negative	strongsubj
autocratic	negative	strongsubj
awareness	neutral	strongsubj
aware	neutral	strongsubj
avalanche	negative	strongsubj
avarice	negative	strongsubj
avaricious	negative	strongsubj
avariciously	negative	strongsubj
avenge	negative	strongsubj
aver	positive	strongsubj
averse	negative	strongsubj
aversion	negative	strongsubj
avid	positive	strongsubj
avidly	positive	strongsubj
awe	positive	strongsubj
awed	positive	strongsubj
awesome	positive	strongsubj
awesomely	positive	strongsubj
awesomeness	positive	strongsubj
awestruck	positive	strongsubj
awful	negative	strongsubj
awfully	negative	strongsubj
awfulness	negative	strongsubj
awkward	negative	strongsubj
awkwardness	negative	strongsubj
ax	negative	strongsubj
babble	negative	strongsubj
baby	neutral	strongsubj
backbite	negative	strongsubj
backbiting	negative	strongsubj
backward	negative	strongsubj
backwardness	negative	strongsubj
bad	negative	strongsubj
badly	negative	strongsubj
baffle	negative	strongsubj
baffled	negative	strongsubj
bafflement	negative	strongsubj
baffling	negative	strongsubj
bait	negative	strongsubj
balk	negative	strongsubj
banal	negative	strongsubj
banalize	negative	strongsubj
bane	negative	strongsubj
banish	negative	strongsubj
banishment	negative	strongsubj
barbarian	negative	strongsubj
barbaric	negative	strongsubj
barbarically	negative	strongsubj
barbarity	negative	strongsubj
barbarous	negative	strongsubj
barbarously	negative	strongsubj
bargain	positive	strongsubj
barren	negative	strongsubj
baseless	negative	strongsubj
bashful	negative	strongsubj
bastard	negative	strongsubj
battle-lines	negative	strongsubj
battleground	negative	strongsubj
batty	negative	strongsubj
beast	negative	strongsubj
beastly	negative	strongsubj
beatify	positive	strongsubj
beauteous	positive	strongsubj
beautiful	positive	strongsubj
beautifully	positive	strongsubj
beautify	positive	strongsubj
beauty	positive	strongsubj
bedlam	negative	strongsubj
bedlamite	negative	strongsubj
befit	positive	strongsubj
befitting	positive	strongsubj
befoul	negative	strongsubj
befriend	positive	strongsubj
beg	negative	strongsubj
beggarly	negative	strongsubj
begging	negative	strongsubj
beguile	negative	strongsubj
belabor	negative	strongsubj
beleaguer	negative	strongsubj
belie	negative	strongsubj
belief	neutral	strongsubj
believable	positive	strongsubj
believe	neutral	strongsubj
belittle	negative	strongsubj
belittled	negative	strongsubj
belittling	negative	strongsubj
bellicose	negative	strongsubj
belligerence	negative	strongsubj
belligerent	negative	strongsubj
belligerently	negative	strongsubj
beloved	positive	strongsubj
bemoan	negative	strongsubj
bemoaning	negative	strongsubj
bemused	negative	strongsubj
beneficent	positive	strongsubj
beneficial	positive	strongsubj
beneficially	positive	strongsubj
beneficiary	positive	strongsubj
benevolence	positive	strongsubj
benevolent	positive	strongsubj
berate	negative	strongsubj
bereave	negative	strongsubj
bereavement	negative	strongsubj
bereft	negative	strongsubj
berserk	negative	strongsubj
beseech	negative	strongsubj
besides	neutral	strongsubj
besmirch	negative	strongsubj
best	positive	strongsubj
best-known	positive	strongsubj
best-performing	positive	strongsubj
bestial	negative	strongsubj
betray	negative	strongsubj
betrayal	negative	strongsubj
betrayals	negative	strongsubj
betrayer	negative	strongsubj
better	positive	strongsubj
better-known	positive	strongsubj
better-than-expected	positive	strongsubj
bewail	negative	strongsubj
bewilder	negative	strongsubj
bewildered	negative	strongsubj
bewildering	negative	strongsubj
bewilderingly	negative	strongsubj
bewilderment	negative	strongsubj
bewitch	negative	strongsubj
bias	negative	strongsubj
biased	negative	strongsubj
biases	negative	strongsubj
bicker	negative	strongsubj
bickering	negative	strongsubj
bitch	negative	strongsubj
bitchy	negative	strongsubj
biting	negative	strongsubj
bitingly	negative	strongsubj
bitter	negative	strongsubj
bitterly	negative	strongsubj
bitterness	negative	strongsubj
bizarre	negative	strongsubj
blab	negative	strongsubj
blabber	negative	strongsubj
blah	negative	strongsubj
blame	negative	strongsubj
blameless	positive	strongsubj
blameworthy	negative	strongsubj
bland	negative	strongsubj
blandish	negative	strongsubj
blaspheme	negative	strongsubj
blasphemous	negative	strongsubj
blasphemy	negative	strongsubj
blasted	negative	strongsubj
blatant	negative	strongsubj
blatantly	negative	strongsubj
blather	negative	strongsubj
bleak	negative	strongsubj
bleakly	negative	strongsubj
bleakness	negative	strongsubj
bless	positive	strongsubj
blessing	positive	strongsubj
blinding	negative	strongsubj
blindingly	negative	strongsubj
blindside	negative	strongsubj
bliss	positive	strongsubj
blissful	positive	strongsubj
blissfully	positive	strongsubj
blister	negative	strongsubj
blistering	negative	strongsubj
blithe	positive	strongsubj
bloated	negative	strongsubj
blockhead	negative	strongsubj
bloodshed	negative	strongsubj
bloodthirsty	negative	strongsubj
blunder	negative	strongsubj
blundering	negative	strongsubj
blunders	negative	strongsubj
blunt	negative	strongsubj
blurt	negative	strongsubj
boast	positive	strongsubj
boast	negative	strongsubj
boastful	negative	strongsubj
boggle	negative	strongsubj
bogus	negative	strongsubj
boil	negative	strongsubj
boiling	negative	strongsubj
boisterous	negative	strongsubj
bold	positive	strongsubj
boldly	positive	strongsubj
boldness	positive	strongsubj
bolster	positive	strongsubj
bombardment	negative	strongsubj
bombastic	negative	strongsubj
bondage	negative	strongsubj
bonkers	negative	strongsubj
bonny	positive	strongsubj
bore	negative	strongsubj
boredom	negative	strongsubj
boring	negative	strongsubj
botch	negative	strongsubj
bother	negative	strongsubj
bothersome	negative	strongsubj
boundless	positive	strongsubj
bountiful	positive	strongsubj
bowdlerize	negative	strongsubj
brag	both	strongsubj
braggart	negative	strongsubj
bragger	negative	strongsubj
brains	positive	strongsubj
brainwash	negative	strongsubj
brainy	positive	strongsubj
brash	negative	strongsubj
brashly	negative	strongsubj
brashness	negative	strongsubj
brat	negative	strongsubj
bravado	negative	strongsubj
brave	positive	strongsubj
bravery	positive	strongsubj
brazen	negative	strongsubj
brazenly	negative	strongsubj
brazenness	negative	strongsubj
break-point	negative	strongsubj
breathlessness	positive	strongsubj
breathtaking	positive	strongsubj
breathtakingly	positive	strongsubj
brilliant	positive	strongsubj
brilliantly	positive	strongsubj
brimstone	negative	strongsubj
bristle	negative	strongsubj
broken-hearted	negative	strongsubj
brood	negative	strongsubj
brook	positive	strongsubj
browbeat	negative	strongsubj
brusque	negative	strongsubj
brutal	negative	strongsubj
brutalising	negative	strongsubj
brutalities	negative	strongsubj
brutality	negative	strongsubj
brutalize	negative	strongsubj
brutalizing	negative	strongsubj
brutally	negative	strongsubj
brute	negative	strongsubj
brutish	negative	strongsubj
bullies	negative	strongsubj
bully	negative	strongsubj
bullyingly	negative	strongsubj
bungle	negative	strongsubj
bungler	negative	strongsubj
burden	negative	strongsubj
burdensome	negative	strongsubj
burdensomely	negative	strongsubj
burn	negative	strongsubj
busybody	negative	strongsubj
butchery	negative	strongsubj
byzantine	negative	strongsubj
cackle	negative	strongsubj
cajole	negative	strongsubj
calamities	negative	strongsubj
calamitous	negative	strongsubj
calamitously	negative	strongsubj
calamity	negative	strongsubj
callous	negative	strongsubj
calming	positive	strongsubj
calumniate	negative	strongsubj
calumniation	negative	strongsubj
calumnies	negative	strongsubj
calumnious	negative	strongsubj
calumniously	negative	strongsubj
calumny	negative	strongsubj
candid	positive	strongsubj
candor	positive	strongsubj
cannibal	negative	strongsubj
cannibalize	negative	strongsubj
capricious	negative	strongsubj
capriciously	negative	strongsubj
capriciousness	negative	strongsubj
captivate	positive	strongsubj
captivating	positive	strongsubj
captivation	positive	strongsubj
carefree	positive	strongsubj
careless	negative	strongsubj
carelessness	negative	strongsubj
caricature	negative	strongsubj
carnage	negative	strongsubj
carp	negative	strongsubj
cartoonish	negative	strongsubj
castigate	negative	strongsubj
cataclysm	negative	strongsubj
cataclysmal	negative	strongsubj
cataclysmic	negative	strongsubj
cataclysmically	negative	strongsubj
catalyst	positive	strongsubj
catastrophe	negative	strongsubj
catastrophes	negative	strongsubj
catastrophic	negative	strongsubj
catastrophically	negative	strongsubj
catchy	positive	strongsubj
caustic	negative	strongsubj
caustically	negative	strongsubj
cautionary	negative	strongsubj
celebrate	positive	strongsubj
celebrated	positive	strongsubj
celebration	positive	strongsubj
celebratory	positive	strongsubj
censure	negative	strongsubj
certainly	neutral	strongsubj
chafe	negative	strongsubj
chaff	negative	strongsubj
chagrin	negative	strongsubj
chaos	negative	strongsubj
chaotic	negative	strongsubj
charisma	negative	strongsubj
charismatic	positive	strongsubj
charm	positive	strongsubj
charming	positive	strongsubj
charmingly	positive	strongsubj
chaste	positive	strongsubj
chasten	negative	strongsubj
chastise	negative	strongsubj
chastisement	negative	strongsubj
chatter	negative	strongsubj
chatterbox	negative	strongsubj
cheapen	negative	strongsubj
cheap	negative	strongsubj
cheat	negative	strongsubj
cheater	negative	strongsubj
cheer	positive	strongsubj
cheery	positive	strongsubj
cheerful	positive	strongsubj
cheerless	negative	strongsubj
cherish	positive	strongsubj
cherished	positive	strongsubj
cherub	positive	strongsubj
chic	positive	strongsubj
chide	negative	strongsubj
childish	negative	strongsubj
chit	negative	strongsubj
chivalry	positive	strongsubj
chivalrous	positive	strongsubj
civility	positive	strongsubj
clear-cut	positive	strongsubj
clearer	positive	strongsubj
clearly	positive	strongsubj
clever	positive	strongsubj
cliche	negative	strongsubj
cliched	negative	strongsubj
closeness	positive	strongsubj
cloud	negative	strongsubj
clout	positive	strongsubj
clumsy	negative	strongsubj
coax	positive	strongsubj
cocky	negative	strongsubj
coerce	negative	strongsubj
coercion	negative	strongsubj
coercive	negative	strongsubj
cogent	positive	strongsubj
cogitate	neutral	strongsubj
cognizant	neutral	strongsubj
coherence	positive	strongsubj
coldly	negative	strongsubj
collude	negative	strongsubj
collusion	negative	strongsubj
comely	positive	strongsubj
comforting	positive	strongsubj
commend	positive	strongsubj
commendable	positive	strongsubj
commendably	positive	strongsubj
commiserate	negative	strongsubj
commotion	negative	strongsubj
compassion	positive	strongsubj
compassionate	positive	strongsubj
compel	negative	strongsubj
compelling	positive	strongsubj
compensate	positive	strongsubj
complacent	negative	strongsubj
complain	negative	strongsubj
complaining	negative	strongsubj
complaint	negative	strongsubj
complaints	negative	strongsubj
complement	positive	strongsubj
compliant	positive	strongsubj
complicit	negative	strongsubj
compliment	positive	strongsubj
complimentary	positive	strongsubj
comprehend	neutral	strongsubj
compulsion	negative	strongsubj
compulsive	negative	strongsubj
comrades	positive	strongsubj
concede	negative	strongsubj
conceit	negative	strongsubj
conceited	negative	strongsubj
conceivable	positive	strongsubj
concern	negative	strongsubj
concerned	negative	strongsubj
concerns	negative	strongsubj
conciliate	positive	strongsubj
conciliatory	positive	strongsubj
concur	positive	strongsubj
condescend	negative	strongsubj
condescending	negative	strongsubj
condescendingly	negative	strongsubj
condescension	negative	strongsubj
condemn	negative	strongsubj
condemnable	negative	strongsubj
condemnation	negative	strongsubj
condolence	negative	strongsubj
condolences	negative	strongsubj
condone	positive	strongsubj
confess	negative	strongsubj
confession	negative	strongsubj
confessions	negative	strongsubj
confide	neutral	strongsubj
confidence	positive	strongsubj
confident	positive	strongsubj
confrontation	negative	strongsubj
confuse	negative	strongsubj
confused	negative	strongsubj
confusing	negative	strongsubj
confusion	negative	strongsubj
confute	positive	strongsubj
congenial	positive	strongsubj
congratulate	positive	strongsubj
congratulations	positive	strongsubj
congratulatory	positive	strongsubj
conjecture	neutral	strongsubj
conscientious	positive	strongsubj
consensus	positive	strongsubj
consent	positive	strongsubj
consequently	neutral	strongsubj
consider	neutral	strongsubj
considerable	neutral	strongsubj
considerably	neutral	strongsubj
considerate	positive	strongsubj
conspicuous	negative	strongsubj
conspicuously	negative	strongsubj
conspirator	negative	strongsubj
conspiratorial	negative	strongsubj
conspire	negative	strongsubj
constancy	positive	strongsubj
consternation	negative	strongsubj
consummate	positive	strongsubj
contemplate	neutral	strongsubj
contempt	negative	strongsubj
contemptible	negative	strongsubj
contemptuous	negative	strongsubj
contemptuously	negative	strongsubj
contend	negative	strongsubj
content	positive	strongsubj
contention	negative	strongsubj
contentment	positive	strongsubj
contentious	negative	strongsubj
contort	negative	strongsubj
contortions	negative	strongsubj
contradict	negative	strongsubj
contradiction	negative	strongsubj
contradictory	negative	strongsubj
contrariness	negative	strongsubj
contrary	negative	strongsubj
contravene	negative	strongsubj
contrive	negative	strongsubj
contrived	negative	strongsubj
convenient	positive	strongsubj
conveniently	positive	strongsubj
convincing	positive	strongsubj
convincingly	positive	strongsubj
convoluted	negative	strongsubj
cornerstone	positive	strongsubj
correctly	positive	strongsubj
corrupt	negative	strongsubj
corruption	negative	strongsubj
counterproductive	negative	strongsubj
coupists	negative	strongsubj
courage	positive	strongsubj
courageous	positive	strongsubj
courageously	positive	strongsubj
courageousness	positive	strongsubj
court	positive	strongsubj
courteous	positive	strongsubj
courtesy	positive	strongsubj
courtly	positive	strongsubj
covet	both	strongsubj
coveting	both	strongsubj
covetingly	both	strongsubj
covetous	negative	strongsubj
covetously	both	strongsubj
coward	negative	strongsubj
cowardly	negative	strongsubj
cozy	positive	strongsubj
crafty	negative	strongsubj
cranky	negative	strongsubj
crass	negative	strongsubj
crave	positive	strongsubj
craven	negative	strongsubj
cravenly	negative	strongsubj
craving	positive	strongsubj
craze	negative	strongsubj
crazily	negative	strongsubj
craziness	negative	strongsubj
crazy	negative	strongsubj
creative	positive	strongsubj
credence	positive	strongsubj
credible	positive	strongsubj
credulous	negative	strongsubj
cringe	negative	strongsubj
cripple	negative	strongsubj
crippling	negative	strongsubj
critic	negative	strongsubj
critical	negative	strongsubj
criticism	negative	strongsubj
criticisms	negative	strongsubj
criticize	negative	strongsubj
critics	negative	strongsubj
crook	negative	strongsubj
crooked	negative	strongsubj
cross	negative	strongsubj
cruel	negative	strongsubj
cruelties	negative	strongsubj
cruelty	negative	strongsubj
crusade	positive	strongsubj
crusader	positive	strongsubj
cry	negative	strongsubj
culpable	negative	strongsubj
cuplrit	negative	strongsubj
cumbersome	negative	strongsubj
cure-all	positive	strongsubj
curious	positive	strongsubj
curiously	positive	strongsubj
curse	negative	strongsubj
cursed	negative	strongsubj
curses	negative	strongsubj
cuss	negative	strongsubj
cute	positive	strongsubj
cutthroat	negative	strongsubj
cynical	negative	strongsubj
cynicism	negative	strongsubj
damn	negative	strongsubj
damnable	negative	strongsubj
damnably	negative	strongsubj
damnation	negative	strongsubj
damned	negative	strongsubj
damning	negative	strongsubj
dangerousness	negative	strongsubj
dangle	negative	strongsubj
dare	positive	strongsubj
daring	positive	strongsubj
daringly	positive	strongsubj
darling	positive	strongsubj
darn	negative	strongsubj
dashing	positive	strongsubj
dastard	negative	strongsubj
dastardly	negative	strongsubj
daunt	negative	strongsubj
daunting	negative	strongsubj
dauntingly	negative	strongsubj
dauntless	positive	strongsubj
dawdle	negative	strongsubj
daydream	positive	strongsubj
daydreamer	positive	strongsubj
daze	negative	strongsubj
dazed	negative	strongsubj
dazzle	positive	strongsubj
dazzled	positive	strongsubj
dazzling	positive	strongsubj
deadbeat	negative	strongsubj
deadlock	negative	strongsubj
deadweight	negative	strongsubj
dear	positive	strongsubj
dearth	negative	strongsubj
debacle	negative	strongsubj
debase	negative	strongsubj
debasement	negative	strongsubj
debaser	negative	strongsubj
debatable	negative	strongsubj
debate	negative	strongsubj
debauch	negative	strongsubj
debaucher	negative	strongsubj
debauchery	negative	strongsubj
decadence	negative	strongsubj
decadent	negative	strongsubj
decay	negative	strongsubj
decayed	negative	strongsubj
deceit	negative	strongsubj
deceitful	negative	strongsubj
deceitfully	negative	strongsubj
deceitfulness	negative	strongsubj
deceiving	negative	strongsubj
deceive	negative	strongsubj
deceiver	negative	strongsubj
deceivers	negative	strongsubj
deception	negative	strongsubj
deceptive	negative	strongsubj
deceptively	negative	strongsubj
declaim	negative	strongsubj
decrepit	negative	strongsubj
decrepitude	negative	strongsubj
decry	negative	strongsubj
dedicated	positive	strongsubj
deduce	neutral	strongsubj
deeply	neutral	strongsubj
deepening	negative	strongsubj
defamation	negative	strongsubj
defamations	negative	strongsubj
defamatory	negative	strongsubj
defame	negative	strongsubj
defective	negative	strongsubj
defender	positive	strongsubj
deference	positive	strongsubj
defiance	negative	strongsubj
defiant	negative	strongsubj
defiantly	negative	strongsubj
defile	negative	strongsubj
defiler	negative	strongsubj
definitively	positive	strongsubj
defrauding	negative	strongsubj
deft	positive	strongsubj
defunct	negative	strongsubj
defy	negative	strongsubj
degenerate	negative	strongsubj
degenerately	negative	strongsubj
degeneration	negative	strongsubj
degradation	negative	strongsubj
degrade	negative	strongsubj
degrading	negative	strongsubj
degradingly	negative	strongsubj
dehumanization	negative	strongsubj
dehumanize	negative	strongsubj
deign	negative	strongsubj
deject	negative	strongsubj
dejected	negative	strongsubj
dejectedly	negative	strongsubj
dejection	negative	strongsubj
delectable	positive	strongsubj
delicious	positive	strongsubj
delight	positive	strongsubj
delighted	positive	strongsubj
delightful	positive	strongsubj
delightfully	positive	strongsubj
delightfulness	positive	strongsubj
delirious	negative	strongsubj
delirium	negative	strongsubj
delude	negative	strongsubj
deluded	negative	strongsubj
delusion	negative	strongsubj
delusional	negative	strongsubj
delusions	negative	strongsubj
demand	both	strongsubj
demean	negative	strongsubj
demeaning	negative	strongsubj
demise	negative	strongsubj
demon	negative	strongsubj
demonic	negative	strongsubj
demonize	negative	strongsubj
demoralize	negative	strongsubj
demoralizing	negative	strongsubj
demoralizingly	negative	strongsubj
demystify	positive	strongsubj
denial	negative	strongsubj
denigrate	negative	strongsubj
deny	negative	strongsubj
denounce	negative	strongsubj
denunciate	negative	strongsubj
denunciation	negative	strongsubj
denunciations	negative	strongsubj
deplorable	negative	strongsubj
deplorably	negative	strongsubj
deplore	negative	strongsubj
deploring	negative	strongsubj
deploringly	negative	strongsubj
deprave	negative	strongsubj
depraved	negative	strongsubj
depravedly	negative	strongsubj
deprecate	negative	strongsubj
depressed	negative	strongsubj
depressing	negative	strongsubj
depressingly	negative	strongsubj
deprive	negative	strongsubj
deprived	negative	strongsubj
deride	negative	strongsubj
derision	negative	strongsubj
derisive	negative	strongsubj
derisively	negative	strongsubj
derisiveness	negative	strongsubj
derogatory	negative	strongsubj
desecrate	negative	strongsubj
deserve	positive	strongsubj
deserved	positive	strongsubj
deservedly	positive	strongsubj
deserving	positive	strongsubj
desert	negative	strongsubj
desertion	negative	strongsubj
desiccate	negative	strongsubj
desiccated	negative	strongsubj
desirable	positive	strongsubj
desire	positive	strongsubj
desirous	positive	strongsubj
desolate	negative	strongsubj
desolately	negative	strongsubj
desolation	negative	strongsubj
despair	negative	strongsubj
despairing	negative	strongsubj
despairingly	negative	strongsubj
desperate	negative	strongsubj
desperately	negative	strongsubj
desperation	negative	strongsubj
despicable	negative	strongsubj
despicably	negative	strongsubj
despise	negative	strongsubj
despised	negative	strongsubj
despite	negative	strongsubj
despoil	negative	strongsubj
despoiler	negative	strongsubj
despondence	negative	strongsubj
despondency	negative	strongsubj
despondent	negative	strongsubj
despondently	negative	strongsubj
despot	negative	strongsubj
despotic	negative	strongsubj
despotism	negative	strongsubj
destabilisation	negative	strongsubj
destinies	positive	strongsubj
destiny	positive	strongsubj
destitute	negative	strongsubj
destitution	negative	strongsubj
destroyer	negative	strongsubj
destructive	negative	strongsubj
desultory	negative	strongsubj
determination	positive	strongsubj
detest	negative	strongsubj
detestable	negative	strongsubj
detestably	negative	strongsubj
detriment	negative	strongsubj
detrimental	negative	strongsubj
devastate	negative	strongsubj
devastated	negative	strongsubj
devastating	negative	strongsubj
devastatingly	negative	strongsubj
devil	negative	strongsubj
devilish	negative	strongsubj
devilishly	negative	strongsubj
devilment	negative	strongsubj
devilry	negative	strongsubj
devious	negative	strongsubj
deviously	negative	strongsubj
deviousness	negative	strongsubj
devoid	negative	strongsubj
devote	positive	strongsubj
devoted	positive	strongsubj
devotee	positive	strongsubj
devotion	positive	strongsubj
dexterous	positive	strongsubj
dexterously	positive	strongsubj
dextrous	positive	strongsubj
diabolic	negative	strongsubj
diabolical	negative	strongsubj
diabolically	negative	strongsubj
diametrically	negative	strongsubj
diatribe	negative	strongsubj
diatribes	negative	strongsubj
difficulty	negative	strongsubj
diffidence	negative	strongsubj
dignified	positive	strongsubj
dignity	positive	strongsubj
digress	negative	strongsubj
dilapidated	negative	strongsubj
dilly-dally	negative	strongsubj
dim	negative	strongsubj
dire	negative	strongsubj
direly	negative	strongsubj
direness	negative	strongsubj
disaccord	negative	strongsubj
disadvantage	negative	strongsubj
disadvantageous	negative	strongsubj
disaffect	negative	strongsubj
disaffected	negative	strongsubj
disaffirm	negative	strongsubj
disagree	negative	strongsubj
disagreeable	negative	strongsubj
disagreeably	negative	strongsubj
disagreement	negative	strongsubj
disallow	negative	strongsubj
disappoint	negative	strongsubj
disappointed	negative	strongsubj
disappointing	negative	strongsubj
disappointingly	negative	strongsubj
disappointment	negative	strongsubj
disapprobation	negative	strongsubj
disapproval	negative	strongsubj
disapprove	negative	strongsubj
disapproving	negative	strongsubj
disarray	negative	strongsubj
disaster	negative	strongsubj
disastrous	negative	strongsubj
disastrously	negative	strongsubj
disavow	negative	strongsubj
disavowal	negative	strongsubj
disbelief	negative	strongsubj
disbelieve	negative	strongsubj
disbeliever	negative	strongsubj
discern	neutral	strongsubj
discerning	positive	strongsubj
disclaim	negative	strongsubj
discombobulate	negative	strongsubj
discomfit	negative	strongsubj
discomfititure	negative	strongsubj
disconcert	negative	strongsubj
disconcerted	negative	strongsubj
disconcerting	negative	strongsubj
disconcertingly	negative	strongsubj
disconsolate	negative	strongsubj
disconsolately	negative	strongsubj
disconsolation	negative	strongsubj
discontent	negative	strongsubj
discontented	negative	strongsubj
discontentedly	negative	strongsubj
discontinuity	negative	strongsubj
discord	negative	strongsubj
discordance	negative	strongsubj
discordant	negative	strongsubj
discountenance	negative	strongsubj
discourage	negative	strongsubj
discouragement	negative	strongsubj
discouraging	negative	strongsubj
discouragingly	negative	strongsubj
discourteous	negative	strongsubj
discourteously	negative	strongsubj
discredit	negative	strongsubj
discriminatory	negative	strongsubj
disdain	negative	strongsubj
disdainful	negative	strongsubj
disdainfully	negative	strongsubj
disfavor	negative	strongsubj
disgrace	negative	strongsubj
disgraced	negative	strongsubj
disgraceful	negative	strongsubj
disgracefully	negative	strongsubj
disgruntle	negative	strongsubj
disgruntled	negative	strongsubj
disgust	negative	strongsubj
disgusted	negative	strongsubj
disgustedly	negative	strongsubj
disgustful	negative	strongsubj
disgustfully	negative	strongsubj
disgusting	negative	strongsubj
disgustingly	negative	strongsubj
dishearten	negative	strongsubj
disheartening	negative	strongsubj
dishearteningly	negative	strongsubj
dishonest	negative	strongsubj
dishonestly	negative	strongsubj
dishonesty	negative	strongsubj
dishonor	negative	strongsubj
dishonorable	negative	strongsubj
dishonorablely	negative	strongsubj
disillusion	negative	strongsubj
disillusioned	negative	strongsubj
disinclination	negative	strongsubj
disinclined	negative	strongsubj
disingenuous	negative	strongsubj
disingenuously	negative	strongsubj
disinterest	negative	strongsubj
disinterested	negative	strongsubj
dislike	negative	strongsubj
disloyal	negative	strongsubj
disloyalty	negative	strongsubj
dismal	negative	strongsubj
dismally	negative	strongsubj
dismalness	negative	strongsubj
dismay	negative	strongsubj
dismayed	negative	strongsubj
dismaying	negative	strongsubj
dismayingly	negative	strongsubj
dismissive	negative	strongsubj
dismissively	negative	strongsubj
disobedience	negative	strongsubj
disobedient	negative	strongsubj
disobey	negative	strongsubj
disown	negative	strongsubj
disorganized	negative	strongsubj
disorient	negative	strongsubj
disoriented	negative	strongsubj
disparage	negative	strongsubj
disparaging	negative	strongsubj
disparagingly	negative	strongsubj
dispirit	negative	strongsubj
dispirited	negative	strongsubj
dispiritedly	negative	strongsubj
dispiriting	negative	strongsubj
displease	negative	strongsubj
displeasing	negative	strongsubj
displeasure	negative	strongsubj
disposition	neutral	strongsubj
disprove	negative	strongsubj
disputable	negative	strongsubj
dispute	negative	strongsubj
disputed	negative	strongsubj
disquiet	negative	strongsubj
disquieting	negative	strongsubj
disquietingly	negative	strongsubj
disquietude	negative	strongsubj
disregard	negative	strongsubj
disregardful	negative	strongsubj
disreputable	negative	strongsubj
disrepute	negative	strongsubj
disrespect	negative	strongsubj
disrespectable	negative	strongsubj
disrespectablity	negative	strongsubj
disrespectful	negative	strongsubj
disrespectfully	negative	strongsubj
disrespectfulness	negative	strongsubj
disrespecting	negative	strongsubj
disrupt	negative	strongsubj
disruption	negative	strongsubj
disruptive	negative	strongsubj
dissatisfaction	negative	strongsubj
dissatisfactory	negative	strongsubj
dissatisfied	negative	strongsubj
dissatisfy	negative	strongsubj
dissatisfying	negative	strongsubj
dissemble	negative	strongsubj
dissembler	negative	strongsubj
dissension	negative	strongsubj
dissent	negative	strongsubj
dissenter	negative	strongsubj
dissention	negative	strongsubj
disservice	negative	strongsubj
dissidence	negative	strongsubj
dissident	negative	strongsubj
dissidents	negative	strongsubj
dissocial	negative	strongsubj
dissolute	negative	strongsubj
dissonance	negative	strongsubj
dissonant	negative	strongsubj
dissonantly	negative	strongsubj
dissuade	negative	strongsubj
dissuasive	negative	strongsubj
distaste	negative	strongsubj
distasteful	negative	strongsubj
distastefully	negative	strongsubj
distinguished	positive	strongsubj
distort	negative	strongsubj
distortion	negative	strongsubj
distracting	negative	strongsubj
distraction	negative	strongsubj
distraught	negative	strongsubj
distraughtly	negative	strongsubj
distraughtness	negative	strongsubj
distress	negative	strongsubj
distressed	negative	strongsubj
distressing	negative	strongsubj
distressingly	negative	strongsubj
distrust	negative	strongsubj
distrustful	negative	strongsubj
distrusting	negative	strongsubj
disturb	negative	strongsubj
disturbed	negative	strongsubj
disturbed-let	negative	strongsubj
disturbing	negative	strongsubj
disturbingly	negative	strongsubj
disunity	negative	strongsubj
disvalue	negative	strongsubj
divine	positive	strongsubj
divinely	positive	strongsubj
divisive	negative	strongsubj
divisively	negative	strongsubj
divisiveness	negative	strongsubj
dizzy	negative	strongsubj
dizzing	negative	strongsubj
dizzingly	negative	strongsubj
doddering	negative	strongsubj
dodge	positive	strongsubj
dodgey	negative	strongsubj
dogged	negative	strongsubj
doggedly	negative	strongsubj
dogmatic	negative	strongsubj
doldrums	negative	strongsubj
domination	negative	strongsubj
domineer	negative	strongsubj
domineering	negative	strongsubj
doom	negative	strongsubj
doomsday	negative	strongsubj
dote	positive	strongsubj
dotingly	positive	strongsubj
doubt	negative	strongsubj
doubtful	negative	strongsubj
doubtfully	negative	strongsubj
doubtless	positive	strongsubj
doubts	negative	strongsubj
downbeat	negative	strongsubj
downcast	negative	strongsubj
downer	negative	strongsubj
downfall	negative	strongsubj
downfallen	negative	strongsubj
downhearted	negative	strongsubj
downheartedly	negative	strongsubj
downright	neutral	strongsubj
downside	negative	strongsubj
drab	negative	strongsubj
draconian	negative	strongsubj
draconic	negative	strongsubj
dragon	negative	strongsubj
dragons	negative	strongsubj
dragoon	negative	strongsubj
drain	negative	strongsubj
drama	negative	strongsubj
dramatic	neutral	strongsubj
dramatically	neutral	strongsubj
drastic	negative	strongsubj
drastically	negative	strongsubj
dread	negative	strongsubj
dreadful	negative	strongsubj
dreadfully	negative	strongsubj
dreadfulness	negative	strongsubj
dream	positive	strongsubj
dreamland	positive	strongsubj
dreary	negative	strongsubj
drones	negative	strongsubj
drunk	negative	strongsubj
drunkard	negative	strongsubj
drunken	negative	strongsubj
dubious	negative	strongsubj
dubiously	negative	strongsubj
dubitable	negative	strongsubj
dullard	negative	strongsubj
dumb	negative	strongsubj
dumbfound	negative	strongsubj
dumbfounded	negative	strongsubj
dummy	negative	strongsubj
dunce	negative	strongsubj
dungeon	negative	strongsubj
dungeons	negative	strongsubj
dupe	negative	strongsubj
eager	positive	strongsubj
eagerly	positive	strongsubj
eagerness	positive	strongsubj
earnest	positive	strongsubj
earnestly	positive	strongsubj
earnestness	positive	strongsubj
earsplitting	negative	strongsubj
easygoing	positive	strongsubj
ebullience	positive	strongsubj
ebullient	positive	strongsubj
ebulliently	positive	strongsubj
eclectic	positive	strongsubj
ecstasies	positive	strongsubj
ecstasy	positive	strongsubj
ecstatic	positive	strongsubj
ecstatically	positive	strongsubj
edgy	negative	strongsubj
edify	positive	strongsubj
effigy	negative	strongsubj
effortless	positive	strongsubj
effortlessly	positive	strongsubj
effrontery	negative	strongsubj
effusion	positive	strongsubj
effusive	positive	strongsubj
effusively	positive	strongsubj
effusiveness	positive	strongsubj
ego	negative	strongsubj
egocentric	negative	strongsubj
egomania	negative	strongsubj
egotism	negative	strongsubj
egotistical	negative	strongsubj
egotistically	negative	strongsubj
egregious	negative	strongsubj
egregiously	negative	strongsubj
ejaculate	negative	strongsubj
elaborate	neutral	strongsubj
elan	positive	strongsubj
elated	positive	strongsubj
elatedly	positive	strongsubj
elation	positive	strongsubj
election-rigger	negative	strongsubj
electrification	positive	strongsubj
elegance	positive	strongsubj
elegant	positive	strongsubj
elegantly	positive	strongsubj
eloquence	positive	strongsubj
eloquent	positive	strongsubj
eloquently	positive	strongsubj
emaciated	negative	strongsubj
emasculate	negative	strongsubj
embarrass	negative	strongsubj
embarrassing	negative	strongsubj
embarrassingly	negative	strongsubj
embarrassment	negative	strongsubj
embellish	positive	strongsubj
embodiment	neutral	strongsubj
embrace	positive	strongsubj
embroil	negative	strongsubj
embroiled	negative	strongsubj
embroilment	negative	strongsubj
eminence	positive	strongsubj
eminent	positive	strongsubj
emotion	neutral	strongsubj
emotional	negative	strongsubj
empathize	negative	strongsubj
empathy	negative	strongsubj
emphatic	negative	strongsubj
emphatically	negative	strongsubj
emptiness	negative	strongsubj
enchant	positive	strongsubj
enchanted	positive	strongsubj
enchanting	positive	strongsubj
enchantingly	positive	strongsubj
encouragement	positive	strongsubj
encouraging	positive	strongsubj
encouragingly	positive	strongsubj
endanger	negative	strongsubj
endear	positive	strongsubj
endearing	positive	strongsubj
endorse	positive	strongsubj
endorsement	positive	strongsubj
endorser	positive	strongsubj
endurable	positive	strongsubj
endure	positive	strongsubj
enduring	positive	strongsubj
enervate	negative	strongsubj
enfeeble	negative	strongsubj
enflame	negative	strongsubj
engaging	positive	strongsubj
engrossing	positive	strongsubj
enjoin	negative	strongsubj
enjoyable	positive	strongsubj
enjoyably	positive	strongsubj
enjoyment	positive	strongsubj
enmity	negative	strongsubj
ennoble	positive	strongsubj
enormities	negative	strongsubj
enormity	negative	strongsubj
enormous	negative	strongsubj
enormously	negative	strongsubj
enrage	negative	strongsubj
enraged	negative	strongsubj
enrapt	positive	strongsubj
enraptured	positive	strongsubj
enslave	negative	strongsubj
entertaining	positive	strongsubj
enthral	positive	strongsubj
enthrall	positive	strongsubj
enthralled	positive	strongsubj
enthuse	positive	strongsubj
enthusiasm	positive	strongsubj
enthusiast	positive	strongsubj
enthusiastic	positive	strongsubj
enthusiastically	positive	strongsubj
entice	positive	strongsubj
enticing	positive	strongsubj
enticingly	positive	strongsubj
entirely	neutral	strongsubj
entranced	positive	strongsubj
entrancing	positive	strongsubj
entrap	negative	strongsubj
entrapment	negative	strongsubj
entreat	positive	strongsubj
entreatingly	positive	strongsubj
entrenchment	neutral	strongsubj
enviable	positive	strongsubj
enviably	positive	strongsubj
envious	negative	strongsubj
enviously	negative	strongsubj
enviousness	negative	strongsubj
envy	negative	strongsubj
epic	positive	strongsubj
epitome	positive	strongsubj
equivocal	negative	strongsubj
err	negative	strongsubj
erratic	negative	strongsubj
erratically	negative	strongsubj
erroneous	negative	strongsubj
erroneously	negative	strongsubj
erudite	positive	strongsubj
eschew	negative	strongsubj
especially	positive	strongsubj
esteem	positive	strongsubj
estranged	negative	strongsubj
eternity	positive	strongsubj
ethical	positive	strongsubj
eulogize	positive	strongsubj
euphoria	positive	strongsubj
euphoric	positive	strongsubj
euphorically	positive	strongsubj
evaluate	neutral	strongsubj
everlasting	positive	strongsubj
evidently	positive	strongsubj
evil	negative	strongsubj
evildoer	negative	strongsubj
evils	negative	strongsubj
eviscerate	negative	strongsubj
evocative	positive	strongsubj
exacerbate	negative	strongsubj
exact	neutral	strongsubj
exactly	neutral	strongsubj
exaggerate	negative	strongsubj
exaggeration	negative	strongsubj
exalt	positive	strongsubj
exaltation	positive	strongsubj
exalted	positive	strongsubj
exaltedly	positive	strongsubj
exalting	positive	strongsubj
exaltingly	positive	strongsubj
exasperate	negative	strongsubj
exasperation	negative	strongsubj
exasperating	negative	strongsubj
exasperatingly	negative	strongsubj
exceed	positive	strongsubj
exceeding	positive	strongsubj
exceedingly	positive	strongsubj
excel	positive	strongsubj
excellence	positive	strongsubj
excellency	positive	strongsubj
excellent	positive	strongsubj
excellently	positive	strongsubj
exceptional	positive	strongsubj
exceptionally	positive	strongsubj
excessive	negative	strongsubj
excessively	negative	strongsubj
excited	positive	strongsubj
excitedly	positive	strongsubj
excitedness	positive	strongsubj
excitement	positive	strongsubj
exciting	positive	strongsubj
excitingly	positive	strongsubj
exclaim	negative	strongsubj
excoriate	negative	strongsubj
excruciating	negative	strongsubj
excruciatingly	negative	strongsubj
excusable	positive	strongsubj
execrate	negative	strongsubj
exemplar	positive	strongsubj
exemplary	positive	strongsubj
exhilarate	positive	strongsubj
exhilarating	positive	strongsubj
exhilaratingly	positive	strongsubj
exhilaration	positive	strongsubj
exhort	negative	strongsubj
exonerate	positive	strongsubj
exorbitant	negative	strongsubj
exorbitantance	negative	strongsubj
exorbitantly	negative	strongsubj
expansive	positive	strongsubj
expertly	positive	strongsubj
expire	negative	strongsubj
explicit	positive	strongsubj
explicitly	positive	strongsubj
exploit	negative	strongsubj
exploitation	negative	strongsubj
expunge	negative	strongsubj
exquisite	positive	strongsubj
exquisitely	positive	strongsubj
extemporize	neutral	strongsubj
extensively	neutral	strongsubj
exterminate	negative	strongsubj
extermination	negative	strongsubj
extol	positive	strongsubj
extoll	positive	strongsubj
extortion	negative	strongsubj
extraordinarily	positive	strongsubj
extraordinary	positive	strongsubj
extravagance	negative	strongsubj
extravagant	negative	strongsubj
extravagantly	negative	strongsubj
extreme	negative	strongsubj
extremely	negative	strongsubj
exuberance	positive	strongsubj
exuberant	positive	strongsubj
exuberantly	positive	strongsubj
exult	positive	strongsubj
exultation	positive	strongsubj
exultingly	positive	strongsubj
fabrication	negative	strongsubj
fabulous	positive	strongsubj
fabulously	positive	strongsubj
facetious	negative	strongsubj
facetiously	negative	strongsubj
fact	neutral	strongsubj
facts	neutral	strongsubj
failing	negative	strongsubj
fainthearted	negative	strongsubj
faith	positive	strongsubj
faithful	positive	strongsubj
faithfully	positive	strongsubj
faithfulness	positive	strongsubj
faithless	negative	strongsubj
fake	negative	strongsubj
fallacies	negative	strongsubj
fallacious	negative	strongsubj
fallaciously	negative	strongsubj
fallaciousness	negative	strongsubj
fallacy	negative	strongsubj
fallout	negative	strongsubj
false	negative	strongsubj
falsehood	negative	strongsubj
falsely	negative	strongsubj
falsify	negative	strongsubj
falter	negative	strongsubj
fame	positive	strongsubj
famed	positive	strongsubj
famine	negative	strongsubj
famished	negative	strongsubj
famously	positive	strongsubj
fanatic	negative	strongsubj
fanatical	negative	strongsubj
fanatically	negative	strongsubj
fanaticism	negative	strongsubj
fanatics	negative	strongsubj
fanciful	negative	strongsubj
fancy	positive	strongsubj
fanfare	positive	strongsubj
fantastic	positive	strongsubj
fantastically	positive	strongsubj
fantasy	positive	strongsubj
far-fetched	negative	strongsubj
farfetched	negative	strongsubj
farce	negative	strongsubj
farcical	negative	strongsubj
farcical-yet-provocative	negative	strongsubj
farcically	negative	strongsubj
fascinate	positive	strongsubj
fascinating	positive	strongsubj
fascinatingly	positive	strongsubj
fascination	positive	strongsubj
fascism	negative	strongsubj
fascist	negative	strongsubj
fashionable	positive	strongsubj
fashionably	positive	strongsubj
fastidious	negative	strongsubj
fastidiously	negative	strongsubj
fastuous	negative	strongsubj
fatalistic	negative	strongsubj
fatalistically	negative	strongsubj
fateful	negative	strongsubj
fatefully	negative	strongsubj
fathomless	negative	strongsubj
fatuity	negative	strongsubj
fatuous	negative	strongsubj
fatuously	negative	strongsubj
fault	negative	strongsubj
favor	positive	strongsubj
favorable	positive	strongsubj
favorite	positive	strongsubj
fawn	both	strongsubj
fawningly	negative	strongsubj
favour	positive	strongsubj
fear	negative	strongsubj
fearful	negative	strongsubj
fearfully	negative	strongsubj
fearless	positive	strongsubj
fearlessly	positive	strongsubj
fears	negative	strongsubj
fearsome	negative	strongsubj
featly	positive	strongsubj
feckless	negative	strongsubj
feebleminded	negative	strongsubj
feel	neutral	strongsubj
feels	neutral	strongsubj
felt	neutral	strongsubj
feeling	neutral	strongsubj
feelings	neutral	strongsubj
feisty	positive	strongsubj
felicitate	positive	strongsubj
felicitous	positive	strongsubj
felicity	positive	strongsubj
fell	negative	strongsubj
ferocious	negative	strongsubj
ferociously	negative	strongsubj
ferocity	negative	strongsubj
fervent	positive	strongsubj
fervently	positive	strongsubj
fervid	positive	strongsubj
fervidly	positive	strongsubj
fervor	positive	strongsubj
festive	positive	strongsubj
fetid	negative	strongsubj
fiasco	negative	strongsubj
fib	negative	strongsubj
fibber	negative	strongsubj
fickle	negative	strongsubj
fictitious	negative	strongsubj
fidelity	positive	strongsubj
fidget	negative	strongsubj
fidgety	negative	strongsubj
fiend	negative	strongsubj
fiendish	negative	strongsubj
filth	negative	strongsubj
filthy	negative	strongsubj
finally	neutral	strongsubj
finely	positive	strongsubj
first-rate	positive	strongsubj
fit	positive	strongsubj
fitting	positive	strongsubj
fixer	neutral	strongsubj
flabbergast	negative	strongsubj
flabbergasted	negative	strongsubj
flagrant	negative	strongsubj
flagrantly	negative	strongsubj
flak	negative	strongsubj
flat-out	negative	strongsubj
flatter	positive	strongsubj
flattering	positive	strongsubj
flatteringly	positive	strongsubj
flaunt	negative	strongsubj
flawless	positive	strongsubj
flawlessly	positive	strongsubj
fleer	negative	strongsubj
flexible	positive	strongsubj
flighty	negative	strongsubj
flimflam	negative	strongsubj
flirt	negative	strongsubj
flirty	negative	strongsubj
floored	negative	strongsubj
flounder	negative	strongsubj
floundering	negative	strongsubj
flourish	positive	strongsubj
flourishing	positive	strongsubj
flout	negative	strongsubj
foe	negative	strongsubj
fond	positive	strongsubj
fondly	positive	strongsubj
fondness	positive	strongsubj
fool	negative	strongsubj
foolhardy	negative	strongsubj
foolish	negative	strongsubj
foolishly	negative	strongsubj
foolishness	negative	strongsubj
forbid	negative	strongsubj
forbidden	negative	strongsubj
foreboding	negative	strongsubj
forebodingly	negative	strongsubj
foremost	positive	strongsubj
forsee	neutral	strongsubj
foresight	positive	strongsubj
foretell	neutral	strongsubj
forgave	positive	strongsubj
forget	negative	strongsubj
forgetful	negative	strongsubj
forgetfully	negative	strongsubj
forgetfulness	negative	strongsubj
forgive	positive	strongsubj
forgiven	positive	strongsubj
forgiveness	positive	strongsubj
forgiving	positive	strongsubj
forgivingly	positive	strongsubj
forlorn	negative	strongsubj
forlornly	negative	strongsubj
formidable	negative	strongsubj
forsake	negative	strongsubj
forsaken	negative	strongsubj
forswear	negative	strongsubj
fortitude	positive	strongsubj
fortress	neutral	strongsubj
fortuitous	positive	strongsubj
fortuitously	positive	strongsubj
fortunate	positive	strongsubj
fortunately	positive	strongsubj
fortune	positive	strongsubj
foul	negative	strongsubj
foully	negative	strongsubj
foulness	negative	strongsubj
fractious	negative	strongsubj
fractiously	negative	strongsubj
fragrant	positive	strongsubj
frank	positive	strongsubj
frankly	neutral	strongsubj
frantic	negative	strongsubj
frantically	negative	strongsubj
franticly	negative	strongsubj
fraternize	negative	strongsubj
fraught	negative	strongsubj
freak	negative	strongsubj
freakish	negative	strongsubj
freakishly	negative	strongsubj
frazzle	negative	strongsubj
frazzled	negative	strongsubj
frenetic	negative	strongsubj
frenetically	negative	strongsubj
frenzied	negative	strongsubj
frenzy	negative	strongsubj
fret	negative	strongsubj
fretful	negative	strongsubj
friction	negative	strongsubj
frictions	negative	strongsubj
friendliness	positive	strongsubj
friendly	positive	strongsubj
friggin	negative	strongsubj
fright	negative	strongsubj
frighten	negative	strongsubj
frightening	negative	strongsubj
frighteningly	negative	strongsubj
frightful	negative	strongsubj
frightfully	negative	strongsubj
frivolous	negative	strongsubj
frolic	positive	strongsubj
frown	negative	strongsubj
fruitless	negative	strongsubj
fruitlessly	negative	strongsubj
fun	negative	strongsubj
frustrate	negative	strongsubj
frustrated	negative	strongsubj
frustrating	negative	strongsubj
frustratingly	negative	strongsubj
frustration	negative	strongsubj
fudge	negative	strongsubj
fulminate	negative	strongsubj
fume	negative	strongsubj
fun	positive	strongsubj
fundamental	neutral	strongsubj
fundamentally	neutral	strongsubj
funny	positive	strongsubj
furious	negative	strongsubj
furiously	negative	strongsubj
furor	negative	strongsubj
furthermore	neutral	strongsubj
fury	negative	strongsubj
fuss	negative	strongsubj
fustigate	negative	strongsubj
fussy	negative	strongsubj
fusty	negative	strongsubj
futile	negative	strongsubj
futilely	negative	strongsubj
futility	negative	strongsubj
gabble	negative	strongsubj
gaff	negative	strongsubj
gaffe	negative	strongsubj
gaiety	positive	strongsubj
gaily	positive	strongsubj
gainful	positive	strongsubj
gainfully	positive	strongsubj
gainsay	negative	strongsubj
gainsayer	negative	strongsubj
gaga	negative	strongsubj
gaggle	negative	strongsubj
gall	negative	strongsubj
gallant	positive	strongsubj
gallantly	positive	strongsubj
galling	negative	strongsubj
gallingly	negative	strongsubj
galore	positive	strongsubj
gape	negative	strongsubj
garish	negative	strongsubj
gasp	negative	strongsubj
gauche	negative	strongsubj
gaudy	negative	strongsubj
gawk	negative	strongsubj
gawky	negative	strongsubj
geezer	negative	strongsubj
generosity	positive	strongsubj
generous	positive	strongsubj
generously	positive	strongsubj
genius	positive	strongsubj
genocide	negative	strongsubj
get-rich	negative	strongsubj
ghastly	negative	strongsubj
gibber	negative	strongsubj
gibberish	negative	strongsubj
gibe	negative	strongsubj
giddy	positive	strongsubj
gifted	positive	strongsubj
glad	positive	strongsubj
gladden	positive	strongsubj
gladly	positive	strongsubj
gladness	positive	strongsubj
glamorous	positive	strongsubj
glare	negative	strongsubj
glaring	negative	strongsubj
glaringly	negative	strongsubj
glean	neutral	strongsubj
glee	positive	strongsubj
gleeful	positive	strongsubj
gleefully	positive	strongsubj
glib	negative	strongsubj
glibly	negative	strongsubj
glimmer	positive	strongsubj
glimmering	positive	strongsubj
glisten	positive	strongsubj
glistening	positive	strongsubj
glitter	positive	strongsubj
gloat	both	strongsubj
gloatingly	negative	strongsubj
gloom	negative	strongsubj
gloomy	negative	strongsubj
glorify	positive	strongsubj
glorious	positive	strongsubj
gloriously	positive	strongsubj
glory	positive	strongsubj
gloss	negative	strongsubj
glossy	positive	strongsubj
glow	positive	strongsubj
glower	negative	strongsubj
glowing	positive	strongsubj
glowingly	positive	strongsubj
glum	negative	strongsubj
goad	negative	strongsubj
goading	negative	strongsubj
god-awful	negative	strongsubj
god-given	positive	strongsubj
goddam	negative	strongsubj
goddamn	negative	strongsubj
godlike	positive	strongsubj
goodness	positive	strongsubj
goodwill	positive	strongsubj
goof	negative	strongsubj
gorgeous	positive	strongsubj
gorgeously	positive	strongsubj
gossip	negative	strongsubj
grace	positive	strongsubj
graceful	positive	strongsubj
gracefully	positive	strongsubj
graceless	negative	strongsubj
gracelessly	negative	strongsubj
gracious	positive	strongsubj
graciously	positive	strongsubj
graciousness	positive	strongsubj
grandeur	positive	strongsubj
grandiose	negative	strongsubj
grate	negative	strongsubj
grateful	positive	strongsubj
gratefully	positive	strongsubj
gratification	positive	strongsubj
gratify	positive	strongsubj
gratifying	positive	strongsubj
gratifyingly	positive	strongsubj
grating	negative	strongsubj
gratitude	positive	strongsubj
gratuitous	negative	strongsubj
gratuitously	negative	strongsubj
grave	negative	strongsubj
gravely	negative	strongsubj
great	positive	strongsubj
greatest	positive	strongsubj
greatly	neutral	strongsubj
greatness	positive	strongsubj
greed	negative	strongsubj
greedy	negative	strongsubj
greet	positive	strongsubj
grief	negative	strongsubj
grievance	negative	strongsubj
grievances	negative	strongsubj
grieve	negative	strongsubj
grieving	negative	strongsubj
grievous	negative	strongsubj
grievously	negative	strongsubj
grim	negative	strongsubj
grimace	negative	strongsubj
grin	positive	strongsubj
grind	negative	strongsubj
gripe	negative	strongsubj
grisly	negative	strongsubj
grit	positive	strongsubj
grossly	negative	strongsubj
grotesque	negative	strongsubj
grouch	negative	strongsubj
grouchy	negative	strongsubj
groundbreaking	positive	strongsubj
groundless	negative	strongsubj
grouse	negative	strongsubj
growl	negative	strongsubj
grudge	negative	strongsubj
grudges	negative	strongsubj
grudging	negative	strongsubj
grudgingly	negative	strongsubj
gruesome	negative	strongsubj
gruesomely	negative	strongsubj
gruff	negative	strongsubj
grumble	negative	strongsubj
guile	negative	strongsubj
guilt	negative	strongsubj
guiltless	positive	strongsubj
guiltily	negative	strongsubj
gullible	negative	strongsubj
gumption	positive	strongsubj
gusto	positive	strongsubj
gutsy	positive	strongsubj
haggard	negative	strongsubj
haggle	negative	strongsubj
hail	positive	strongsubj
halcyon	positive	strongsubj
hale	positive	strongsubj
halfhearted	negative	strongsubj
halfheartedly	negative	strongsubj
hallowed	positive	strongsubj
hallucinate	negative	strongsubj
hallucination	negative	strongsubj
hamper	negative	strongsubj
hamstring	negative	strongsubj
hamstrung	negative	strongsubj
handily	positive	strongsubj
handsome	positive	strongsubj
handy	positive	strongsubj
hanker	positive	strongsubj
hapless	negative	strongsubj
happily	positive	strongsubj
happiness	positive	strongsubj
happy	positive	strongsubj
harangue	negative	strongsubj
harassment	negative	strongsubj
hard-line	negative	strongsubj
hard-liner	negative	strongsubj
hardball	negative	strongsubj
hardheaded	negative	strongsubj
hardhearted	negative	strongsubj
hardier	positive	strongsubj
hardly	negative	strongsubj
hardship	negative	strongsubj
hardships	negative	strongsubj
harm	negative	strongsubj
harmful	negative	strongsubj
harmless	positive	strongsubj
harmonious	positive	strongsubj
harmoniously	positive	strongsubj
harmonize	positive	strongsubj
harmony	positive	strongsubj
harms	negative	strongsubj
harpy	negative	strongsubj
harridan	negative	strongsubj
harried	negative	strongsubj
harrow	negative	strongsubj
harsh	negative	strongsubj
harshly	negative	strongsubj
hassle	negative	strongsubj
haste	negative	strongsubj
hasty	negative	strongsubj
hate	negative	strongsubj
hater	negative	strongsubj
hateful	negative	strongsubj
hatefully	negative	strongsubj
hatefulness	negative	strongsubj
haughtily	negative	strongsubj
haughty	negative	strongsubj
hatred	negative	strongsubj
haunting	negative	strongsubj
haven	positive	strongsubj
havoc	negative	strongsubj
hawkish	negative	strongsubj
heady	positive	strongsubj
healthful	positive	strongsubj
heartbreak	negative	strongsubj
heartbreaker	negative	strongsubj
heartbreaking	negative	strongsubj
heartbreakingly	negative	strongsubj
hearten	positive	strongsubj
heartening	positive	strongsubj
heartfelt	positive	strongsubj
heartily	positive	strongsubj
heartless	negative	strongsubj
heartrending	negative	strongsubj
heartwarming	positive	strongsubj
heathen	negative	strongsubj
heavenly	positive	strongsubj
heavily	negative	strongsubj
heavy-handed	negative	strongsubj
heavyhearted	negative	strongsubj
heck	negative	strongsubj
heckle	negative	strongsubj
hedge	negative	strongsubj
hedonistic	negative	strongsubj
heedless	negative	strongsubj
hegemonistic	negative	strongsubj
hegemony	negative	strongsubj
heinous	negative	strongsubj
hell	negative	strongsubj
hell-bent	negative	strongsubj
hellion	negative	strongsubj
herald	positive	strongsubj
heresy	negative	strongsubj
heretic	negative	strongsubj
heretical	negative	strongsubj
hero	positive	strongsubj
heroic	positive	strongsubj
heroically	positive	strongsubj
heroine	positive	strongsubj
heroize	positive	strongsubj
heros	positive	strongsubj
hesitant	negative	strongsubj
hideous	negative	strongsubj
hideously	negative	strongsubj
hideousness	negative	strongsubj
highlight	positive	strongsubj
hilarious	positive	strongsubj
hilariously	positive	strongsubj
hilariousness	positive	strongsubj
hilarity	positive	strongsubj
hinder	negative	strongsubj
hindrance	negative	strongsubj
hm	neutral	strongsubj
hmm	neutral	strongsubj
hoard	negative	strongsubj
hoax	negative	strongsubj
hollow	negative	strongsubj
homage	positive	strongsubj
honest	positive	strongsubj
honestly	positive	strongsubj
honesty	positive	strongsubj
honor	positive	strongsubj
honorable	positive	strongsubj
hoodwink	negative	strongsubj
hope	positive	strongsubj
hopeful	positive	strongsubj
hopefully	positive	strongsubj
hopefulness	positive	strongsubj
hopeless	negative	strongsubj
hopelessly	negative	strongsubj
hopelessness	negative	strongsubj
hopes	positive	strongsubj
horrendous	negative	strongsubj
horrendously	negative	strongsubj
horrible	negative	strongsubj
horribly	negative	strongsubj
horrid	negative	strongsubj
horrific	negative	strongsubj
horrifically	negative	strongsubj
horrify	negative	strongsubj
horrifying	negative	strongsubj
horrifyingly	negative	strongsubj
horror	negative	strongsubj
horrors	negative	strongsubj
hospitable	positive	strongsubj
hostility	negative	strongsubj
hothead	negative	strongsubj
hotheaded	negative	strongsubj
hotbeds	negative	strongsubj
hubris	negative	strongsubj
huckster	negative	strongsubj
hug	positive	strongsubj
humane	positive	strongsubj
humankind	positive	strongsubj
humble	positive	strongsubj
humbling	negative	strongsubj
humiliate	negative	strongsubj
humiliating	negative	strongsubj
humiliation	negative	strongsubj
humility	positive	strongsubj
humor	positive	strongsubj
humorous	positive	strongsubj
humorously	positive	strongsubj
humour	positive	strongsubj
humourous	positive	strongsubj
hunger	negative	strongsubj
hypocrisy	negative	strongsubj
hypocrite	negative	strongsubj
hypocrites	negative	strongsubj
hypocritical	negative	strongsubj
hypocritically	negative	strongsubj
hysteria	negative	strongsubj
hysteric	negative	strongsubj
hysterical	negative	strongsubj
hysterically	negative	strongsubj
hysterics	negative	strongsubj
ideal	positive	strongsubj
idealize	positive	strongsubj
ideally	positive	strongsubj
idiocies	negative	strongsubj
idiocy	negative	strongsubj
idiot	negative	strongsubj
idiotic	negative	strongsubj
idiotically	negative	strongsubj
idiots	negative	strongsubj
idol	positive	strongsubj
idolize	positive	strongsubj
idolized	positive	strongsubj
idyllic	positive	strongsubj
ignoble	negative	strongsubj
ignominious	negative	strongsubj
ignominiously	negative	strongsubj
ignominy	negative	strongsubj
ignorance	negative	strongsubj
ignorant	negative	strongsubj
ill-advised	negative	strongsubj
ill-conceived	negative	strongsubj
ill-fated	negative	strongsubj
ill-favored	negative	strongsubj
ill-mannered	negative	strongsubj
ill-natured	negative	strongsubj
ill-sorted	negative	strongsubj
ill-tempered	negative	strongsubj
ill-treated	negative	strongsubj
ill-treatment	negative	strongsubj
ill-usage	negative	strongsubj
ill-used	negative	strongsubj
illogic	negative	strongsubj
illogical	negative	strongsubj
illogically	negative	strongsubj
illuminate	positive	strongsubj
illuminati	positive	strongsubj
illuminating	positive	strongsubj
illumine	positive	strongsubj
illusion	negative	strongsubj
illusions	negative	strongsubj
illusory	negative	strongsubj
illustrious	positive	strongsubj
imaginary	negative	strongsubj
imagination	neutral	strongsubj
imaginative	positive	strongsubj
imagine	neutral	strongsubj
imbalance	negative	strongsubj
imbecile	negative	strongsubj
imbroglio	negative	strongsubj
immaculate	positive	strongsubj
immaculately	positive	strongsubj
immaterial	negative	strongsubj
immediately	neutral	strongsubj
immensely	neutral	strongsubj
immensity	neutral	strongsubj
immensurable	neutral	strongsubj
imminence	negative	strongsubj
imminent	negative	strongsubj
imminently	negative	strongsubj
immoderate	negative	strongsubj
immoderately	negative	strongsubj
immodest	negative	strongsubj
immoral	negative	strongsubj
immorality	negative	strongsubj
immorally	negative	strongsubj
immovable	negative	strongsubj
impair	negative	strongsubj
impaired	negative	strongsubj
impasse	negative	strongsubj
impassioned	positive	strongsubj
impatience	negative	strongsubj
impatient	negative	strongsubj
impatiently	negative	strongsubj
impeach	negative	strongsubj
impeccable	positive	strongsubj
impeccably	positive	strongsubj
impede	negative	strongsubj
impedance	negative	strongsubj
impediment	negative	strongsubj
impel	positive	strongsubj
impending	negative	strongsubj
impenitent	negative	strongsubj
imperative	neutral	strongsubj
imperatively	neutral	strongsubj
imperialist	negative	strongsubj
imperil	negative	strongsubj
imperious	negative	strongsubj
imperiously	negative	strongsubj
impertinent	negative	strongsubj
imperturbable	positive	strongsubj
impervious	positive	strongsubj
impetuous	negative	strongsubj
impetuously	negative	strongsubj
impiety	negative	strongsubj
impinge	negative	strongsubj
impious	negative	strongsubj
implacable	negative	strongsubj
implausible	negative	strongsubj
implausibly	negative	strongsubj
implode	negative	strongsubj
implore	both	strongsubj
imploring	both	strongsubj
imploringly	both	strongsubj
imply	neutral	strongsubj
impolite	negative	strongsubj
impolitely	negative	strongsubj
impolitic	negative	strongsubj
importunate	negative	strongsubj
importune	negative	strongsubj
impose	negative	strongsubj
imposers	negative	strongsubj
imposition	negative	strongsubj
impotent	negative	strongsubj
impractical	negative	strongsubj
imprecate	negative	strongsubj
impregnable	positive	strongsubj
impressive	positive	strongsubj
impressively	positive	strongsubj
impressiveness	positive	strongsubj
improbability	negative	strongsubj
improbable	negative	strongsubj
improbably	negative	strongsubj
improper	negative	strongsubj
improperly	negative	strongsubj
impropriety	negative	strongsubj
improvise	positive	strongsubj
imprudence	negative	strongsubj
imprudent	negative	strongsubj
impudence	negative	strongsubj
impudent	negative	strongsubj
impudently	negative	strongsubj
impugn	negative	strongsubj
impulsive	negative	strongsubj
impulsively	negative	strongsubj
impure	negative	strongsubj
impurity	negative	strongsubj
inaccurate	negative	strongsubj
inaccurately	negative	strongsubj
inane	negative	strongsubj
inanely	negative	strongsubj
inappropriate	negative	strongsubj
inappropriately	negative	strongsubj
inapt	negative	strongsubj
inaptitude	negative	strongsubj
inarguable	neutral	strongsubj
inarguably	neutral	strongsubj
inarticulate	negative	strongsubj
inattentive	negative	strongsubj
incapable	negative	strongsubj
incapably	negative	strongsubj
incautious	negative	strongsubj
incendiary	negative	strongsubj
incessant	negative	strongsubj
incessantly	negative	strongsubj
incisive	positive	strongsubj
incisively	positive	strongsubj
incisiveness	positive	strongsubj
incivility	negative	strongsubj
inclination	positive	strongsubj
inclinations	positive	strongsubj
inclined	positive	strongsubj
incognizant	negative	strongsubj
incoherence	negative	strongsubj
incoherent	negative	strongsubj
incoherently	negative	strongsubj
incommensurate	negative	strongsubj
incompetence	negative	strongsubj
incompetent	negative	strongsubj
incompetently	negative	strongsubj
incomprehensible	negative	strongsubj
incomprehension	negative	strongsubj
inconceivable	negative	strongsubj
inconceivably	negative	strongsubj
incongruous	negative	strongsubj
incongruously	negative	strongsubj
inconsequent	negative	strongsubj
inconsequently	negative	strongsubj
inconsequential	negative	strongsubj
inconsequentially	negative	strongsubj
inconsiderate	negative	strongsubj
inconsiderately	negative	strongsubj
inconsistence	negative	strongsubj
inconsistencies	negative	strongsubj
inconsolable	negative	strongsubj
inconsolably	negative	strongsubj
inconstant	negative	strongsubj
incontestable	positive	strongsubj
incontrovertible	positive	strongsubj
inconvenience	negative	strongsubj
inconvenient	negative	strongsubj
inconveniently	negative	strongsubj
incorrectly	negative	strongsubj
incorrigible	negative	strongsubj
incorrigibly	negative	strongsubj
incorruptible	positive	strongsubj
incredible	positive	strongsubj
incredibly	positive	strongsubj
incredulous	negative	strongsubj
incredulously	negative	strongsubj
inculcate	negative	strongsubj
indecency	negative	strongsubj
indecent	negative	strongsubj
indecently	negative	strongsubj
indecision	negative	strongsubj
indecisive	negative	strongsubj
indecisively	negative	strongsubj
indecorum	negative	strongsubj
indeed	neutral	strongsubj
indefatigable	positive	strongsubj
indefensible	negative	strongsubj
indelible	positive	strongsubj
indelibly	positive	strongsubj
indelicate	negative	strongsubj
indescribable	positive	strongsubj
indescribably	positive	strongsubj
indestructible	positive	strongsubj
indicative	neutral	strongsubj
indifference	negative	strongsubj
indifferent	negative	strongsubj
indignant	negative	strongsubj
indignantly	negative	strongsubj
indignation	negative	strongsubj
indignity	negative	strongsubj
indiscreet	negative	strongsubj
indiscreetly	negative	strongsubj
indiscretion	negative	strongsubj
indiscriminate	negative	strongsubj
indiscriminating	negative	strongsubj
indiscriminately	negative	strongsubj
indispensable	positive	strongsubj
indispensability	positive	strongsubj
indisposed	negative	strongsubj
indisputable	positive	strongsubj
indoctrinate	negative	strongsubj
indoctrination	negative	strongsubj
indolent	negative	strongsubj
indomitable	positive	strongsubj
indomitably	positive	strongsubj
indubitable	positive	strongsubj
indubitably	positive	strongsubj
indulge	negative	strongsubj
indulgence	positive	strongsubj
indulgent	positive	strongsubj
inefficacious	negative	strongsubj
inefficacy	negative	strongsubj
inelegance	negative	strongsubj
inelegant	negative	strongsubj
ineloquent	negative	strongsubj
ineloquently	negative	strongsubj
inept	negative	strongsubj
ineptitude	negative	strongsubj
ineptly	negative	strongsubj
inequality	negative	strongsubj
inequitable	negative	strongsubj
inequitably	negative	strongsubj
inequities	negative	strongsubj
inescapable	negative	strongsubj
inescapably	negative	strongsubj
inessential	negative	strongsubj
inestimable	positive	strongsubj
inestimably	positive	strongsubj
inevitable	negative	strongsubj
inevitably	negative	strongsubj
inexcusable	negative	strongsubj
inexcusably	negative	strongsubj
inexorable	negative	strongsubj
inexorably	negative	strongsubj
inexpiable	negative	strongsubj
inexplainable	negative	strongsubj
inexplicable	negative	strongsubj
inextricable	negative	strongsubj
inextricably	negative	strongsubj
infallible	positive	strongsubj
infallibly	positive	strongsubj
infallibility	positive	strongsubj
infamous	negative	strongsubj
infamously	negative	strongsubj
infamy	negative	strongsubj
infatuated	both	strongsubj
infer	neutral	strongsubj
inferior	negative	strongsubj
inferiority	negative	strongsubj
infernal	negative	strongsubj
infidel	negative	strongsubj
infidels	negative	strongsubj
infirm	negative	strongsubj
inflame	negative	strongsubj
inflammatory	negative	strongsubj
inflexible	negative	strongsubj
inflict	negative	strongsubj
infringe	negative	strongsubj
infringement	negative	strongsubj
infringements	negative	strongsubj
infuriate	negative	strongsubj
infuriated	negative	strongsubj
infuriating	negative	strongsubj
infuriatingly	negative	strongsubj
ingenious	positive	strongsubj
ingeniously	positive	strongsubj
ingenuity	positive	strongsubj
ingenuous	positive	strongsubj
ingenuously	positive	strongsubj
inglorious	negative	strongsubj
ingrate	negative	strongsubj
ingratiate	positive	strongsubj
ingratiating	positive	strongsubj
ingratiatingly	positive	strongsubj
ingratitude	negative	strongsubj
inherent	neutral	strongsubj
inhospitable	negative	strongsubj
inhospitality	negative	strongsubj
inhuman	negative	strongsubj
inhumane	negative	strongsubj
inhumanity	negative	strongsubj
inimical	negative	strongsubj
inimically	negative	strongsubj
iniquitous	negative	strongsubj
iniquity	negative	strongsubj
injudicious	negative	strongsubj
injustice	negative	strongsubj
injustices	negative	strongsubj
inkling	neutral	strongsubj
inklings	neutral	strongsubj
innocuous	positive	strongsubj
innuendo	negative	strongsubj
inoffensive	positive	strongsubj
inopportune	negative	strongsubj
inordinate	negative	strongsubj
inordinately	negative	strongsubj
inquisitive	positive	strongsubj
insane	negative	strongsubj
insanely	negative	strongsubj
insanity	negative	strongsubj
insatiable	negative	strongsubj
insecurity	negative	strongsubj
insensitive	negative	strongsubj
insensitively	negative	strongsubj
insensitivity	negative	strongsubj
insidious	negative	strongsubj
insidiously	negative	strongsubj
insight	positive	strongsubj
insightful	positive	strongsubj
insightfully	positive	strongsubj
insights	neutral	strongsubj
insincere	negative	strongsubj
insincerely	negative	strongsubj
insincerity	negative	strongsubj
insinuate	negative	strongsubj
insinuating	negative	strongsubj
insinuation	negative	strongsubj
insist	positive	strongsubj
insistent	positive	strongsubj
insistently	positive	strongsubj
insociable	negative	strongsubj
insolence	negative	strongsubj
insolent	negative	strongsubj
insolently	negative	strongsubj
insouciance	negative	strongsubj
inspiration	positive	strongsubj
inspirational	positive	strongsubj
inspire	positive	strongsubj
inspiring	positive	strongsubj
instigate	negative	strongsubj
instigator	negative	strongsubj
instigators	negative	strongsubj
insubstantial	negative	strongsubj
insubstantially	negative	strongsubj
insufferable	negative	strongsubj
insufferably	negative	strongsubj
insult	negative	strongsubj
insulted	negative	strongsubj
insulting	negative	strongsubj
insultingly	negative	strongsubj
insupportable	negative	strongsubj
insupportably	negative	strongsubj
integrity	positive	strongsubj
intelligent	positive	strongsubj
intelligible	positive	strongsubj
interesting	positive	strongsubj
intimacy	positive	strongsubj
intimate	neutral	strongsubj
intimidating	negative	strongsubj
intimidatingly	negative	strongsubj
intolerable	negative	strongsubj
intolerablely	negative	strongsubj
intolerance	negative	strongsubj
intolerant	negative	strongsubj
intransigence	negative	strongsubj
intransigent	negative	strongsubj
intrigue	positive	strongsubj
intriguing	positive	strongsubj
intriguingly	positive	strongsubj
intrude	negative	strongsubj
intrusive	negative	strongsubj
intuitive	positive	strongsubj
inundate	negative	strongsubj
inundated	negative	strongsubj
invalid	negative	strongsubj
invalidate	negative	strongsubj
invalidity	negative	strongsubj
invaluable	positive	strongsubj
invaluablely	positive	strongsubj
invective	negative	strongsubj
inveigle	negative	strongsubj
invidious	negative	strongsubj
invidiously	negative	strongsubj
invidiousness	negative	strongsubj
invigorating	positive	strongsubj
invincibility	positive	strongsubj
invincible	positive	strongsubj
inviolable	positive	strongsubj
inviolate	positive	strongsubj
invulnerable	positive	strongsubj
irate	negative	strongsubj
irately	negative	strongsubj
ire	negative	strongsubj
irk	negative	strongsubj
irksome	negative	strongsubj
ironic	negative	strongsubj
ironies	negative	strongsubj
irony	negative	strongsubj
irrational	negative	strongsubj
irrationality	negative	strongsubj
irrationally	negative	strongsubj
irreconcilable	negative	strongsubj
irredeemable	negative	strongsubj
irredeemably	negative	strongsubj
irreformable	negative	strongsubj
irrefutable	positive	strongsubj
irrefutably	positive	strongsubj
irregardless	neutral	strongsubj
irrelevance	negative	strongsubj
irrelevant	negative	strongsubj
irreparable	negative	strongsubj
irreplacible	negative	strongsubj
irrepressible	negative	strongsubj
irreproachable	positive	strongsubj
irresistible	positive	strongsubj
irresistibly	positive	strongsubj
irresolute	negative	strongsubj
irresponsible	negative	strongsubj
irresponsibly	negative	strongsubj
irreverence	negative	strongsubj
irreverent	negative	strongsubj
irreverently	negative	strongsubj
irreversible	negative	strongsubj
irritable	negative	strongsubj
irritably	negative	strongsubj
irritate	negative	strongsubj
irritated	negative	strongsubj
irritating	negative	strongsubj
irritation	negative	strongsubj
itch	negative	strongsubj
jabber	negative	strongsubj
jaded	negative	strongsubj
jaundiced	negative	strongsubj
jauntily	positive	strongsubj
jaunty	positive	strongsubj
jealous	negative	strongsubj
jealously	negative	strongsubj
jealousness	negative	strongsubj
jealousy	negative	strongsubj
jeer	negative	strongsubj
jeering	negative	strongsubj
jeeringly	negative	strongsubj
jeers	negative	strongsubj
jeopardize	negative	strongsubj
jeopardy	negative	strongsubj
jerk	negative	strongsubj
jest	positive	strongsubj
jittery	negative	strongsubj
joke	positive	strongsubj
joker	negative	strongsubj
jolly	positive	strongsubj
jovial	positive	strongsubj
joy	positive	strongsubj
joyful	positive	strongsubj
joyfully	positive	strongsubj
joyless	positive	strongsubj
joyous	positive	strongsubj
joyously	positive	strongsubj
jubilant	positive	strongsubj
jubilantly	positive	strongsubj
jubilate	positive	strongsubj
jubilation	positive	strongsubj
judicious	positive	strongsubj
just	positive	strongsubj
justifiable	positive	strongsubj
justifiably	positive	strongsubj
justification	positive	strongsubj
justify	positive	strongsubj
justly	positive	strongsubj
kaput	negative	strongsubj
keen	positive	strongsubj
keen	negative	strongsubj
keenly	positive	strongsubj
keenness	positive	strongsubj
kemp	positive	strongsubj
kick	negative	strongsubj
kid	positive	strongsubj
killjoy	negative	strongsubj
kind	positive	strongsubj
kindly	positive	strongsubj
kindliness	positive	strongsubj
kindness	positive	strongsubj
kingmaker	positive	strongsubj
knave	negative	strongsubj
knew	neutral	strongsubj
know	neutral	strongsubj
knowing	neutral	strongsubj
knowingly	neutral	strongsubj
knowledge	neutral	strongsubj
knowledgeable	positive	strongsubj
kook	negative	strongsubj
kooky	negative	strongsubj
lack	negative	strongsubj
lackadaisical	negative	strongsubj
lackey	negative	strongsubj
lackeys	negative	strongsubj
lacking	negative	strongsubj
lackluster	negative	strongsubj
laconic	negative	strongsubj
lambast	negative	strongsubj
lambaste	negative	strongsubj
lame-duck	negative	strongsubj
lament	negative	strongsubj
lamentable	negative	strongsubj
lamentably	negative	strongsubj
languid	negative	strongsubj
languish	negative	strongsubj
languor	negative	strongsubj
languorous	negative	strongsubj
languorously	negative	strongsubj
lark	positive	strongsubj
lascivious	negative	strongsubj
last-ditch	negative	strongsubj
lastly	neutral	strongsubj
laud	positive	strongsubj
laudable	positive	strongsubj
laudably	positive	strongsubj
laugh	negative	strongsubj
laughable	negative	strongsubj
laughably	negative	strongsubj
laughingstock	negative	strongsubj
laughter	negative	strongsubj
lavish	positive	strongsubj
lavishly	positive	strongsubj
law-abiding	positive	strongsubj
lawbreaker	negative	strongsubj
lawbreaking	negative	strongsubj
lawless	negative	strongsubj
lawlessness	negative	strongsubj
lax	negative	strongsubj
lazy	negative	strongsubj
lech	negative	strongsubj
lecher	negative	strongsubj
lecherous	negative	strongsubj
lechery	negative	strongsubj
leech	negative	strongsubj
leer	negative	strongsubj
leery	negative	strongsubj
left-leaning	negative	strongsubj
letch	negative	strongsubj
levity	positive	strongsubj
lewd	negative	strongsubj
lewdly	negative	strongsubj
lewdness	negative	strongsubj
liability	negative	strongsubj
liar	negative	strongsubj
liars	negative	strongsubj
liberate	positive	strongsubj
liberty	positive	strongsubj
licentious	negative	strongsubj
licentiously	negative	strongsubj
licentiousness	negative	strongsubj
lie	negative	strongsubj
lier	negative	strongsubj
lies	negative	strongsubj
lifeblood	positive	strongsubj
light-hearted	positive	strongsubj
likable	positive	strongsubj
like	positive	strongsubj
liking	positive	strongsubj
likewise	neutral	strongsubj
limitless	neutral	strongsubj
limp	negative	strongsubj
lionhearted	positive	strongsubj
listless	negative	strongsubj
litigious	negative	strongsubj
little	negative	strongsubj
little-known	negative	strongsubj
lively	positive	strongsubj
livid	negative	strongsubj
lividly	negative	strongsubj
loath	negative	strongsubj
loathe	negative	strongsubj
loathing	negative	strongsubj
loathly	negative	strongsubj
loathsome	negative	strongsubj
loathsomely	negative	strongsubj
lofty	positive	strongsubj
lone	negative	strongsubj
loneliness	negative	strongsubj
lonely	negative	strongsubj
lonesome	negative	strongsubj
long	negative	strongsubj
longing	negative	strongsubj
longingly	negative	strongsubj
loophole	negative	strongsubj
loopholes	negative	strongsubj
loot	negative	strongsubj
lorn	negative	strongsubj
losing	negative	strongsubj
lousy	negative	strongsubj
lovable	positive	strongsubj
lovably	positive	strongsubj
love	positive	strongsubj
loveless	negative	strongsubj
loveliness	positive	strongsubj
lovelorn	negative	strongsubj
lover	positive	strongsubj
lovely	positive	strongsubj
low-rated	negative	strongsubj
lowly	negative	strongsubj
loyalty	positive	strongsubj
lucid	positive	strongsubj
lucidly	positive	strongsubj
luck	positive	strongsubj
luckier	positive	strongsubj
luckiest	positive	strongsubj
luckily	positive	strongsubj
luckiness	positive	strongsubj
lucky	positive	strongsubj
ludicrous	negative	strongsubj
ludicrously	negative	strongsubj
lugubrious	negative	strongsubj
lukewarm	negative	strongsubj
lunatic	negative	strongsubj
lunaticism	negative	strongsubj
lurch	negative	strongsubj
lure	negative	strongsubj
lurid	negative	strongsubj
lurk	negative	strongsubj
lurking	negative	strongsubj
lush	positive	strongsubj
lust	both	strongsubj
luster	positive	strongsubj
lustrous	positive	strongsubj
luxuriant	positive	strongsubj
luxurious	positive	strongsubj
luxuriously	positive	strongsubj
luxury	positive	strongsubj
lying	negative	strongsubj
lyrical	positive	strongsubj
macabre	negative	strongsubj
mad	negative	strongsubj
madden	negative	strongsubj
maddening	negative	strongsubj
maddeningly	negative	strongsubj
madder	negative	strongsubj
madly	negative	strongsubj
madman	negative	strongsubj
madness	negative	strongsubj
magic	positive	strongsubj
magical	positive	strongsubj
magnanimous	positive	strongsubj
magnanimously	positive	strongsubj
magnificence	positive	strongsubj
magnificent	positive	strongsubj
magnificently	positive	strongsubj
majestic	positive	strongsubj
majesty	positive	strongsubj
maladjusted	negative	strongsubj
maladjustment	negative	strongsubj
malcontent	negative	strongsubj
malcontented	negative	strongsubj
maledict	negative	strongsubj
malevolence	negative	strongsubj
malevolent	negative	strongsubj
malevolently	negative	strongsubj
malice	negative	strongsubj
malicious	negative	strongsubj
maliciously	negative	strongsubj
maliciousness	negative	strongsubj
malign	negative	strongsubj
malodorous	negative	strongsubj
maltreatment	negative	strongsubj
mangle	negative	strongsubj
mania	negative	strongsubj
maniac	negative	strongsubj
maniacal	negative	strongsubj
manic	negative	strongsubj
manifest	positive	strongsubj
manipulative	negative	strongsubj
manipulators	negative	strongsubj
manly	positive	strongsubj
mannerly	positive	strongsubj
mantra	neutral	strongsubj
mar	negative	strongsubj
martyrdom	negative	strongsubj
martyrdom-seeking	negative	strongsubj
marvel	positive	strongsubj
marvellous	positive	strongsubj
marvelous	positive	strongsubj
marvelously	positive	strongsubj
marvelousness	positive	strongsubj
marvels	positive	strongsubj
massacre	negative	strongsubj
massacres	negative	strongsubj
master	positive	strongsubj
masterful	positive	strongsubj
masterfully	positive	strongsubj
masterpiece	positive	strongsubj
masterpieces	positive	strongsubj
masters	positive	strongsubj
mastery	positive	strongsubj
matchless	positive	strongsubj
maverick	negative	strongsubj
mawkish	negative	strongsubj
mawkishly	negative	strongsubj
mawkishness	negative	strongsubj
maxi-devaluation	negative	strongsubj
maximize	positive	strongsubj
maybe	neutral	strongsubj
meager	negative	strongsubj
mean	negative	strongsubj
meaningful	positive	strongsubj
meaningless	negative	strongsubj
meanness	negative	strongsubj
meddle	negative	strongsubj
meddlesome	negative	strongsubj
mediocre	negative	strongsubj
mediocrity	negative	strongsubj
meek	positive	strongsubj
melancholy	negative	strongsubj
mellow	positive	strongsubj
melodramatic	negative	strongsubj
melodramatically	negative	strongsubj
memorable	positive	strongsubj
memorialize	positive	strongsubj
menace	negative	strongsubj
menacing	negative	strongsubj
menacingly	negative	strongsubj
mendacious	negative	strongsubj
mendacity	negative	strongsubj
mentality	neutral	strongsubj
merciful	positive	strongsubj
mercifully	positive	strongsubj
merciless	negative	strongsubj
mercilessly	negative	strongsubj
mercy	positive	strongsubj
mere	negative	strongsubj
merely	negative	strongsubj
merit	positive	strongsubj
meritorious	positive	strongsubj
merrily	positive	strongsubj
merriment	positive	strongsubj
merriness	positive	strongsubj
merry	positive	strongsubj
mesmerize	positive	strongsubj
mesmerizing	positive	strongsubj
mesmerizingly	positive	strongsubj
mess	negative	strongsubj
metaphorize	neutral	strongsubj
midget	negative	strongsubj
might	positive	strongsubj
mightily	positive	strongsubj
mighty	positive	strongsubj
militancy	negative	strongsubj
mindful	positive	strongsubj
mindless	negative	strongsubj
mindlessly	negative	strongsubj
miracle	positive	strongsubj
miracles	positive	strongsubj
miraculous	positive	strongsubj
miraculously	positive	strongsubj
miraculousness	positive	strongsubj
mirage	negative	strongsubj
mire	negative	strongsubj
mirth	positive	strongsubj
misbecoming	negative	strongsubj
misbecome	negative	strongsubj
misbegotten	negative	strongsubj
misbehave	negative	strongsubj
misbehavior	negative	strongsubj
mischief	negative	strongsubj
mischievous	negative	strongsubj
mischievously	negative	strongsubj
misconception	negative	strongsubj
misconceptions	negative	strongsubj
miscreant	negative	strongsubj
miscreants	negative	strongsubj
misdirection	negative	strongsubj
miser	negative	strongsubj
miserly	negative	strongsubj
miserable	negative	strongsubj
miserableness	negative	strongsubj
miserably	negative	strongsubj
miseries	negative	strongsubj
misery	negative	strongsubj
misfit	negative	strongsubj
misfortune	negative	strongsubj
misgiving	negative	strongsubj
misgivings	negative	strongsubj
misguidance	negative	strongsubj
misguide	negative	strongsubj
misguided	negative	strongsubj
mishandle	negative	strongsubj
mishap	negative	strongsubj
misinform	negative	strongsubj
misinformed	negative	strongsubj
misinterpret	negative	strongsubj
misjudge	negative	strongsubj
misjudgment	negative	strongsubj
mislead	negative	strongsubj
misleading	negative	strongsubj
misleadingly	negative	strongsubj
mislike	negative	strongsubj
mismanage	negative	strongsubj
misread	negative	strongsubj
misreading	negative	strongsubj
misrepresent	negative	strongsubj
misrepresentation	negative	strongsubj
misstatement	negative	strongsubj
mistake	negative	strongsubj
mistaken	negative	strongsubj
mistakenly	negative	strongsubj
mistakes	negative	strongsubj
mistrust	negative	strongsubj
mistrustful	negative	strongsubj
mistrustfully	negative	strongsubj
misunderstand	negative	strongsubj
misunderstood	negative	strongsubj
misunderstanding	negative	strongsubj
misunderstandings	negative	strongsubj
misuse	negative	strongsubj
mm	neutral	strongsubj
moan	negative	strongsubj
mock	negative	strongsubj
mockeries	negative	strongsubj
mockery	negative	strongsubj
mocking	negative	strongsubj
mockingly	negative	strongsubj
moderate	positive	strongsubj
moderation	positive	strongsubj
molest	negative	strongsubj
molestation	negative	strongsubj
mollify	positive	strongsubj
momentous	positive	strongsubj
monotonous	negative	strongsubj
monotony	negative	strongsubj
monster	negative	strongsubj
monstrosities	negative	strongsubj
monstrosity	negative	strongsubj
monstrous	negative	strongsubj
monstrously	negative	strongsubj
monumental	positive	strongsubj
monumentally	positive	strongsubj
moody	negative	strongsubj
moral	positive	strongsubj
morality	positive	strongsubj
moralize	positive	strongsubj
morbid	negative	strongsubj
morbidly	negative	strongsubj
mordant	negative	strongsubj
mordantly	negative	strongsubj
moreover	neutral	strongsubj
moribund	negative	strongsubj
mortification	negative	strongsubj
mortified	negative	strongsubj
mortify	negative	strongsubj
mortifying	negative	strongsubj
motivate	positive	strongsubj
motivated	positive	strongsubj
motivation	positive	strongsubj
motley	negative	strongsubj
mourn	negative	strongsubj
mourner	negative	strongsubj
mournful	negative	strongsubj
mournfully	negative	strongsubj
moving	positive	strongsubj
mudslinger	negative	strongsubj
mudslinging	negative	strongsubj
mulish	negative	strongsubj
multi-polarization	negative	strongsubj
mum	neutral	strongsubj
mundane	negative	strongsubj
muscle-flexing	negative	strongsubj
must	neutral	strongsubj
mysterious	negative	strongsubj
mysteriously	negative	strongsubj
mystery	negative	strongsubj
myth	negative	strongsubj
nag	negative	strongsubj
nagging	negative	strongsubj
naive	negative	strongsubj
naively	negative	strongsubj
narrower	negative	strongsubj
nastily	negative	strongsubj
nastiness	negative	strongsubj
nasty	negative	strongsubj
nationalism	negative	strongsubj
naughty	negative	strongsubj
nauseating	negative	strongsubj
nauseatingly	negative	strongsubj
nebulous	negative	strongsubj
nebulously	negative	strongsubj
need	neutral	strongsubj
needful	neutral	strongsubj
needfully	neutral	strongsubj
nefarious	negative	strongsubj
nefariously	negative	strongsubj
neglect	negative	strongsubj
neglected	negative	strongsubj
negligent	negative	strongsubj
negligence	negative	strongsubj
nemesis	negative	strongsubj
nettlesome	negative	strongsubj
nevertheless	neutral	strongsubj
nervous	negative	strongsubj
nervously	negative	strongsubj
nervousness	negative	strongsubj
neurotic	negative	strongsubj
neurotically	negative	strongsubj
nice	positive	strongsubj
nicely	positive	strongsubj
nifty	positive	strongsubj
nightmare	negative	strongsubj
nightmarish	negative	strongsubj
nightmarishly	negative	strongsubj
nimble	positive	strongsubj
nix	negative	strongsubj
noble	positive	strongsubj
nobly	positive	strongsubj
non-confidence	negative	strongsubj
nonsense	negative	strongsubj
nosey	negative	strongsubj
notable	positive	strongsubj
notably	positive	strongsubj
noteworthy	positive	strongsubj
notorious	negative	strongsubj
notoriously	negative	strongsubj
novel	positive	strongsubj
nuance	neutral	strongsubj
nuances	neutral	strongsubj
nuisance	negative	strongsubj
nurture	positive	strongsubj
nurturing	positive	strongsubj
oasis	positive	strongsubj
obedience	positive	strongsubj
obedient	positive	strongsubj
obediently	positive	strongsubj
obey	positive	strongsubj
obese	negative	strongsubj
object	negative	strongsubj
objection	negative	strongsubj
objectionable	negative	strongsubj
objections	negative	strongsubj
obliged	positive	strongsubj
obliterate	negative	strongsubj
obliterated	negative	strongsubj
oblivious	negative	strongsubj
obnoxious	negative	strongsubj
obnoxiously	negative	strongsubj
obscene	negative	strongsubj
obscenely	negative	strongsubj
obscenity	negative	strongsubj
obscure	negative	strongsubj
obscurity	negative	strongsubj
obsess	negative	strongsubj
obsession	negative	strongsubj
obsessions	negative	strongsubj
obsessive	negative	strongsubj
obsessively	negative	strongsubj
obsessiveness	negative	strongsubj
obstacle	negative	strongsubj
obstinate	negative	strongsubj
obstinately	negative	strongsubj
obtrusive	negative	strongsubj
obtuse	negative	strongsubj
obviate	positive	strongsubj
obviously	negative	strongsubj
odder	negative	strongsubj
oddest	negative	strongsubj
oddities	negative	strongsubj
oddity	negative	strongsubj
oddly	negative	strongsubj
offbeat	positive	strongsubj
offend	negative	strongsubj
offending	negative	strongsubj
offenses	negative	strongsubj
offensively	negative	strongsubj
offensiveness	negative	strongsubj
officious	negative	strongsubj
oh	neutral	strongsubj
okay	positive	strongsubj
ominous	negative	strongsubj
ominously	negative	strongsubj
one-side	negative	strongsubj
one-sided	negative	strongsubj
onerous	negative	strongsubj
onerously	negative	strongsubj
opinion	neutral	strongsubj
opinionated	negative	strongsubj
opinions	neutral	strongsubj
opponent	negative	strongsubj
opportune	positive	strongsubj
opportunity	positive	strongsubj
oppose	negative	strongsubj
opposition	negative	strongsubj
oppositions	negative	strongsubj
oppress	negative	strongsubj
oppression	negative	strongsubj
oppressive	negative	strongsubj
oppressively	negative	strongsubj
oppressiveness	negative	strongsubj
oppressors	negative	strongsubj
optimal	positive	strongsubj
optimism	positive	strongsubj
opulent	positive	strongsubj
ordeal	negative	strongsubj
orthodoxy	neutral	strongsubj
ostracize	negative	strongsubj
ought	neutral	strongsubj
outburst	negative	strongsubj
outbursts	negative	strongsubj
outcast	negative	strongsubj
outcry	negative	strongsubj
outdo	positive	strongsubj
outlaw	negative	strongsubj
outrage	negative	strongsubj
outraged	negative	strongsubj
outrageous	negative	strongsubj
outrageously	negative	strongsubj
outrageousness	negative	strongsubj
outrages	negative	strongsubj
outright	neutral	strongsubj
outshine	positive	strongsubj
outsmart	positive	strongsubj
outstanding	positive	strongsubj
outstandingly	positive	strongsubj
outstrip	positive	strongsubj
outwit	positive	strongsubj
ovation	positive	strongsubj
over-acted	negative	strongsubj
overachiever	positive	strongsubj
overact	negative	strongsubj
overacted	negative	strongsubj
overbearing	negative	strongsubj
overbearingly	negative	strongsubj
overblown	negative	strongsubj
overcome	negative	strongsubj
overdo	negative	strongsubj
overdone	negative	strongsubj
overdue	negative	strongsubj
overemphasize	negative	strongsubj
overjoyed	positive	strongsubj
overkill	negative	strongsubj
overlook	negative	strongsubj
overplay	negative	strongsubj
overstate	negative	strongsubj
overstatement	negative	strongsubj
overstatements	negative	strongsubj
overture	positive	strongsubj
overwhelming	negative	strongsubj
overwhelmingly	negative	strongsubj
overworked	negative	strongsubj
overzealous	negative	strongsubj
overzealously	negative	strongsubj
pacifist	positive	strongsubj
pacifists	positive	strongsubj
pain	negative	strongsubj
pains	negative	strongsubj
painstaking	positive	strongsubj
painstakingly	positive	strongsubj
palatable	positive	strongsubj
palatial	positive	strongsubj
palliate	positive	strongsubj
paltry	negative	strongsubj
pandemonium	negative	strongsubj
panic	negative	strongsubj
panicky	negative	strongsubj
paradise	positive	strongsubj
paradoxical	negative	strongsubj
paradoxically	negative	strongsubj
paramount	positive	strongsubj
paranoia	negative	strongsubj
paranoid	negative	strongsubj
pardon	positive	strongsubj
pariah	negative	strongsubj
parody	negative	strongsubj
partiality	negative	strongsubj
partisan	negative	strongsubj
partisans	negative	strongsubj
passe	negative	strongsubj
passion	positive	strongsubj
passionate	positive	strongsubj
passionately	positive	strongsubj
passive	negative	strongsubj
passiveness	negative	strongsubj
pathetic	negative	strongsubj
pathetically	negative	strongsubj
patience	positive	strongsubj
patiently	positive	strongsubj
patriot	positive	strongsubj
patriotic	positive	strongsubj
patronize	negative	strongsubj
paucity	negative	strongsubj
pauper	negative	strongsubj
paupers	negative	strongsubj
payback	negative	strongsubj
peaceable	positive	strongsubj
peculiar	negative	strongsubj
peculiarly	negative	strongsubj
pedantic	negative	strongsubj
peerless	positive	strongsubj
peeve	negative	strongsubj
peeved	negative	strongsubj
peevish	negative	strongsubj
peevishly	negative	strongsubj
penalize	negative	strongsubj
penetrating	positive	strongsubj
penitent	positive	strongsubj
perceptions	neutral	strongsubj
perceptive	positive	strongsubj
perfect	positive	strongsubj
perfection	positive	strongsubj
perfectly	positive	strongsubj
perfidious	negative	strongsubj
perfidity	negative	strongsubj
perfunctory	negative	strongsubj
perhaps	neutral	strongsubj
peril	negative	strongsubj
perish	negative	strongsubj
pernicious	negative	strongsubj
perplex	negative	strongsubj
perplexed	negative	strongsubj
perplexing	negative	strongsubj
perplexity	negative	strongsubj
persecute	negative	strongsubj
persecution	negative	strongsubj
perseverance	positive	strongsubj
persevere	positive	strongsubj
personality	positive	strongsubj
perspicuous	positive	strongsubj
perspicuously	positive	strongsubj
persuade	positive	strongsubj
persuasive	positive	strongsubj
persuasively	positive	strongsubj
pertinacious	negative	strongsubj
pertinaciously	negative	strongsubj
pertinacity	negative	strongsubj
perturb	negative	strongsubj
perturbed	negative	strongsubj
pervasive	m	strongsubj negative
perverse	negative	strongsubj
perversely	negative	strongsubj
perversion	negative	strongsubj
perversity	negative	strongsubj
pervert	negative	strongsubj
perverted	negative	strongsubj
pessimism	negative	strongsubj
pessimistic	negative	strongsubj
pessimistically	negative	strongsubj
pest	negative	strongsubj
pestilent	negative	strongsubj
petrify	negative	strongsubj
petrified	negative	strongsubj
pettifog	negative	strongsubj
petty	negative	strongsubj
phenomenal	positive	strongsubj
phenomenally	positive	strongsubj
philosophize	neutral	strongsubj
phobia	negative	strongsubj
phobic	negative	strongsubj
phony	negative	strongsubj
picky	negative	strongsubj
picturesque	positive	strongsubj
pillage	negative	strongsubj
pillar	positive	strongsubj
pillory	negative	strongsubj
pine	negative	strongsubj
pinnacle	positive	strongsubj
pious	positive	strongsubj
pithy	positive	strongsubj
pitiable	negative	strongsubj
pitiful	negative	strongsubj
pitifully	negative	strongsubj
pitiless	negative	strongsubj
pitilessly	negative	strongsubj
pittance	negative	strongsubj
pity	negative	strongsubj
placate	positive	strongsubj
plagiarize	negative	strongsubj
plague	negative	strongsubj
plainly	positive	strongsubj
plausibility	positive	strongsubj
plausible	positive	strongsubj
playful	positive	strongsubj
playfully	positive	strongsubj
plaything	negative	strongsubj
plead	both	strongsubj
pleading	both	strongsubj
pleadingly	both	strongsubj
pleas	negative	strongsubj
please	positive	strongsubj
pleased	positive	strongsubj
pleasing	positive	strongsubj
pleasingly	positive	strongsubj
pleasurable	positive	strongsubj
pleasurably	positive	strongsubj
pleasure	positive	strongsubj
plebeian	negative	strongsubj
pledge	positive	strongsubj
pledges	positive	strongsubj
plenty	positive	strongsubj
plight	negative	strongsubj
plot	negative	strongsubj
plotters	negative	strongsubj
ploy	negative	strongsubj
plunder	negative	strongsubj
plunderer	negative	strongsubj
plush	positive	strongsubj
poetic	positive	strongsubj
poeticize	positive	strongsubj
poignant	positive	strongsubj
poise	positive	strongsubj
poised	positive	strongsubj
poison	negative	strongsubj
polarisation	negative	strongsubj
polemize	negative	strongsubj
polluter	negative	strongsubj
polluters	negative	strongsubj
pompous	negative	strongsubj
ponder	neutral	strongsubj
poorly	negative	strongsubj
posh	positive	strongsubj
positiveness	positive	strongsubj
positively	positive	strongsubj
posturing	negative	strongsubj
potent	positive	strongsubj
pout	negative	strongsubj
poverty	negative	strongsubj
pragmatic	positive	strongsubj
praise	positive	strongsubj
praiseworthy	positive	strongsubj
praising	positive	strongsubj
prate	negative	strongsubj
pratfall	negative	strongsubj
prattle	negative	strongsubj
pray	neutral	strongsubj
preach	positive	strongsubj
preaching	positive	strongsubj
precaution	positive	strongsubj
precautions	positive	strongsubj
precious	positive	strongsubj
precious	neutral	strongsubj
precipitate	negative	strongsubj
precipitous	negative	strongsubj
predicament	negative	strongsubj
prefer	positive	strongsubj
preferable	positive	strongsubj
preferably	positive	strongsubj
preference	positive	strongsubj
preferences	positive	strongsubj
prejudge	negative	strongsubj
prejudice	negative	strongsubj
prejudicial	negative	strongsubj
premeditated	negative	strongsubj
preponderance	positive	strongsubj
preposterous	negative	strongsubj
preposterously	negative	strongsubj
pressing	negative	strongsubj
prestige	positive	strongsubj
presumably	neutral	strongsubj
presume	negative	strongsubj
presumptuous	negative	strongsubj
presumptuously	negative	strongsubj
pretence	negative	strongsubj
pretend	negative	strongsubj
pretense	negative	strongsubj
pretentious	negative	strongsubj
pretentiously	negative	strongsubj
prettily	positive	strongsubj
pretty	positive	strongsubj
prevaricate	negative	strongsubj
priceless	positive	strongsubj
prickle	negative	strongsubj
prickles	negative	strongsubj
pride	positive	strongsubj
prideful	negative	strongsubj
privilege	positive	strongsubj
privileged	positive	strongsubj
prize	positive	strongsubj
pro-American	positive	strongsubj
pro-Beijing	positive	strongsubj
pro-Cuba	positive	strongsubj
pro-peace	positive	strongsubj
proactive	positive	strongsubj
problematic	negative	strongsubj
proclaim	neutral	strongsubj
procrastinate	negative	strongsubj
procrastination	negative	strongsubj
prodigious	positive	strongsubj
prodigiously	positive	strongsubj
prodigy	positive	strongsubj
profane	negative	strongsubj
profanity	negative	strongsubj
profess	positive	strongsubj
proficient	positive	strongsubj
proficiently	positive	strongsubj
profound	positive	strongsubj
profoundly	positive	strongsubj
profuse	positive	strongsubj
profusely	positive	strongsubj
profusion	positive	strongsubj
prognosticate	neutral	strongsubj
promise	positive	strongsubj
promising	positive	strongsubj
promoter	positive	strongsubj
propaganda	negative	strongsubj
propagandize	negative	strongsubj
prophesy	neutral	strongsubj
propitious	positive	strongsubj
propitiously	positive	strongsubj
proscription	negative	strongsubj
proscriptions	negative	strongsubj
prosecute	negative	strongsubj
prosper	positive	strongsubj
protector	positive	strongsubj
protest	negative	strongsubj
proud	positive	strongsubj
providence	positive	strongsubj
provocation	negative	strongsubj
provocative	negative	strongsubj
provoke	negative	strongsubj
prowess	positive	strongsubj
prudent	positive	strongsubj
prudently	positive	strongsubj
pugnacious	negative	strongsubj
pugnaciously	negative	strongsubj
pugnacity	negative	strongsubj
punch	negative	strongsubj
punctual	positive	strongsubj
pundits	positive	strongsubj
punish	negative	strongsubj
puny	negative	strongsubj
puppet	negative	strongsubj
puppets	negative	strongsubj
purposeful	positive	strongsubj
puzzle	negative	strongsubj
puzzled	negative	strongsubj
puzzlement	negative	strongsubj
puzzling	negative	strongsubj
quack	negative	strongsubj
quaint	positive	strongsubj
qualms	negative	strongsubj
quandary	negative	strongsubj
quarrel	negative	strongsubj
quarrellous	negative	strongsubj
quarrellously	negative	strongsubj
quarrels	negative	strongsubj
quarrelsome	negative	strongsubj
quash	negative	strongsubj
quasi-ally	positive	strongsubj
questionable	negative	strongsubj
quibble	negative	strongsubj
quicken	positive	strongsubj
quite	neutral	strongsubj
quitter	negative	strongsubj
racist	negative	strongsubj
racists	negative	strongsubj
rack	negative	strongsubj
radiance	positive	strongsubj
radiant	positive	strongsubj
radical	negative	strongsubj
radicalization	negative	strongsubj
radically	negative	strongsubj
radicals	negative	strongsubj
rage	negative	strongsubj
ragged	negative	strongsubj
raging	negative	strongsubj
rail	negative	strongsubj
rally	positive	strongsubj
rampage	negative	strongsubj
rampant	negative	strongsubj
ramshackle	negative	strongsubj
rancor	negative	strongsubj
rank	negative	strongsubj
rankle	negative	strongsubj
rant	negative	strongsubj
ranting	negative	strongsubj
rantingly	negative	strongsubj
rapport	positive	strongsubj
rapt	positive	strongsubj
rapture	positive	strongsubj
raptureous	positive	strongsubj
raptureously	positive	strongsubj
rapturous	positive	strongsubj
rapturously	positive	strongsubj
rascal	negative	strongsubj
rash	negative	strongsubj
rather	neutral	strongsubj
rational	positive	strongsubj
rationalize	negative	strongsubj
rattle	negative	strongsubj
ravage	negative	strongsubj
rave	positive	strongsubj
raving	negative	strongsubj
re-conquest	positive	strongsubj
reactionary	negative	strongsubj
realist	positive	strongsubj
realistic	positive	strongsubj
realistically	positive	strongsubj
really	neutral	strongsubj
reassurance	positive	strongsubj
reassure	positive	strongsubj
rebellious	negative	strongsubj
rebuff	negative	strongsubj
rebuke	negative	strongsubj
recalcitrant	negative	strongsubj
recant	negative	strongsubj
receptive	positive	strongsubj
reckless	negative	strongsubj
recklessly	negative	strongsubj
recklessness	negative	strongsubj
recoil	negative	strongsubj
recommend	positive	strongsubj
recommendation	positive	strongsubj
recommendations	positive	strongsubj
recommended	positive	strongsubj
rectification	positive	strongsubj
rectify	positive	strongsubj
rectifying	positive	strongsubj
redeem	positive	strongsubj
redeeming	positive	strongsubj
redemption	positive	strongsubj
reflecting	neutral	strongsubj
reflective	neutral	strongsubj
refreshing	positive	strongsubj
refuge	positive	strongsubj
refuse	negative	strongsubj
refutation	negative	strongsubj
refute	negative	strongsubj
regal	positive	strongsubj
regally	positive	strongsubj
regard	positive	strongsubj
regard	neutral	strongsubj
regardless	neutral	strongsubj
regardlessly	neutral	strongsubj
regret	negative	strongsubj
regretful	negative	strongsubj
regretfully	negative	strongsubj
regrettable	negative	strongsubj
regrettably	negative	strongsubj
reject	negative	strongsubj
rejection	negative	strongsubj
rejoice	positive	strongsubj
rejoicing	positive	strongsubj
rejoicingly	positive	strongsubj
relent	positive	strongsubj
relentless	negative	strongsubj
relentlessly	negative	strongsubj
relentlessness	negative	strongsubj
relief	positive	strongsubj
relish	positive	strongsubj
reluctance	negative	strongsubj
remarkable	positive	strongsubj
remarkably	positive	strongsubj
reminiscent	positive	strongsubj
remorse	negative	strongsubj
remorseful	negative	strongsubj
remorsefully	negative	strongsubj
remorseless	negative	strongsubj
remorselessly	negative	strongsubj
remorselessness	negative	strongsubj
remunerate	positive	strongsubj
renaissance	positive	strongsubj
renounce	negative	strongsubj
renown	positive	strongsubj
renowned	positive	strongsubj
renunciation	negative	strongsubj
repay	positive	strongsubj
repent	positive	strongsubj
repentance	positive	strongsubj
reprehensible	negative	strongsubj
reprehensibly	negative	strongsubj
reprehension	negative	strongsubj
reprehensive	negative	strongsubj
reprimand	negative	strongsubj
reproach	negative	strongsubj
reproachful	negative	strongsubj
reprove	negative	strongsubj
reprovingly	negative	strongsubj
repudiate	negative	strongsubj
repudiation	negative	strongsubj
repugn	negative	strongsubj
repugnance	negative	strongsubj
repugnant	negative	strongsubj
repugnantly	negative	strongsubj
repulsing	negative	strongsubj
repulsive	negative	strongsubj
repulsively	negative	strongsubj
repulsiveness	negative	strongsubj
resent	negative	strongsubj
resentful	negative	strongsubj
resentment	negative	strongsubj
resounding	positive	strongsubj
resourceful	positive	strongsubj
resourcefulness	positive	strongsubj
respect	positive	strongsubj
respectable	positive	strongsubj
respectful	positive	strongsubj
respectfully	positive	strongsubj
respite	positive	strongsubj
resplendent	positive	strongsubj
reticent	negative	strongsubj
revealing	neutral	strongsubj
revel	positive	strongsubj
revelatory	neutral	strongsubj
revenge	negative	strongsubj
revengeful	negative	strongsubj
revengefully	negative	strongsubj
revere	positive	strongsubj
reverence	positive	strongsubj
reverent	positive	strongsubj
reverently	positive	strongsubj
revile	negative	strongsubj
reviled	negative	strongsubj
revolting	negative	strongsubj
revoltingly	negative	strongsubj
revulsion	negative	strongsubj
revulsive	negative	strongsubj
reward	positive	strongsubj
rewarding	positive	strongsubj
rewardingly	positive	strongsubj
rhetorical	negative	strongsubj
richly	positive	strongsubj
richness	positive	strongsubj
rid	negative	strongsubj
ridicule	negative	strongsubj
ridiculous	negative	strongsubj
ridiculously	negative	strongsubj
rife	negative	strongsubj
rift	negative	strongsubj
rifts	negative	strongsubj
right	positive	strongsubj
righten	positive	strongsubj
righteous	positive	strongsubj
righteously	positive	strongsubj
righteousness	positive	strongsubj
rightful	positive	strongsubj
rightfully	positive	strongsubj
rightly	positive	strongsubj
rightness	positive	strongsubj
rile	negative	strongsubj
riled	negative	strongsubj
roadblocks	negative	strongsubj
rogue	negative	strongsubj
rollercoaster	negative	strongsubj
romantic	positive	strongsubj
romantically	positive	strongsubj
romanticize	positive	strongsubj
rosy	positive	strongsubj
rotten	negative	strongsubj
rousing	positive	strongsubj
rubbish	negative	strongsubj
rude	negative	strongsubj
rue	negative	strongsubj
ruffian	negative	strongsubj
rumbling	negative	strongsubj
rumor	negative	strongsubj
rumors	negative	strongsubj
rumours	negative	strongsubj
rumple	negative	strongsubj
run-down	negative	strongsubj
runaway	negative	strongsubj
rusty	negative	strongsubj
ruthless	negative	strongsubj
ruthlessly	negative	strongsubj
ruthlessness	negative	strongsubj
sabotage	negative	strongsubj
sacred	positive	strongsubj
sacrifice	negative	strongsubj
sad	negative	strongsubj
sadden	negative	strongsubj
sadly	negative	strongsubj
sadness	negative	strongsubj
safeguard	positive	strongsubj
sagacity	positive	strongsubj
sage	positive	strongsubj
sagely	positive	strongsubj
saint	positive	strongsubj
saintliness	positive	strongsubj
saintly	positive	strongsubj
salacious	negative	strongsubj
salutary	positive	strongsubj
salute	positive	strongsubj
salvation	positive	strongsubj
sanctimonious	negative	strongsubj
sanctify	positive	strongsubj
sanction	positive	strongsubj
sanctity	positive	strongsubj
sanctuary	positive	strongsubj
sanguine	positive	strongsubj
sane	positive	strongsubj
sanity	positive	strongsubj
sap	negative	strongsubj
sarcasm	negative	strongsubj
sarcastic	negative	strongsubj
sarcastically	negative	strongsubj
sardonic	negative	strongsubj
sardonically	negative	strongsubj
sass	negative	strongsubj
satirical	negative	strongsubj
satirize	negative	strongsubj
satisfaction	positive	strongsubj
satisfactorily	positive	strongsubj
satisfactory	positive	strongsubj
savage	negative	strongsubj
savaged	negative	strongsubj
savagely	negative	strongsubj
savagery	negative	strongsubj
savages	negative	strongsubj
savvy	positive	strongsubj
scandalize	negative	strongsubj
scandalized	negative	strongsubj
scandalous	negative	strongsubj
scandalously	negative	strongsubj
scandals	negative	strongsubj
scapegoat	negative	strongsubj
scar	negative	strongsubj
scarred	negative	strongsubj
scarcely	negative	strongsubj
scare	negative	strongsubj
scared	negative	strongsubj
scarier	negative	strongsubj
scariest	negative	strongsubj
scarily	negative	strongsubj
scars	negative	strongsubj
scary	negative	strongsubj
scathing	negative	strongsubj
scathingly	negative	strongsubj
scheming	negative	strongsubj
scoff	negative	strongsubj
scoffingly	negative	strongsubj
scold	negative	strongsubj
scolding	negative	strongsubj
scoldingly	negative	strongsubj
scorching	negative	strongsubj
scorchingly	negative	strongsubj
scorn	negative	strongsubj
scornful	negative	strongsubj
scornfully	negative	strongsubj
scoundrel	negative	strongsubj
scourge	negative	strongsubj
scowl	negative	strongsubj
scream	negative	strongsubj
screaming	neutral	strongsubj
screamingly	neutral	strongsubj
screech	negative	strongsubj
scruples	positive	strongsubj
scrupulous	positive	strongsubj
scrupulously	positive	strongsubj
scrutinize	neutral	strongsubj
scrutiny	neutral	strongsubj
scum	negative	strongsubj
scummy	negative	strongsubj
seamless	positive	strongsubj
second-class	negative	strongsubj
seductive	positive	strongsubj
seedy	negative	strongsubj
seemingly	neutral	strongsubj
seethe	negative	strongsubj
seething	negative	strongsubj
self-coup	negative	strongsubj
self-criticism	negative	strongsubj
self-destructive	negative	strongsubj
self-determination	positive	strongsubj
self-humiliation	negative	strongsubj
self-interest	negative	strongsubj
self-interested	negative	strongsubj
self-respect	positive	strongsubj
self-satisfaction	positive	strongsubj
self-serving	negative	strongsubj
selfinterested	negative	strongsubj
selfish	negative	strongsubj
selfishly	negative	strongsubj
selfishness	negative	strongsubj
senile	negative	strongsubj
sensation	positive	strongsubj
sensational	positive	strongsubj
sensationalize	negative	strongsubj
sensationally	positive	strongsubj
sensations	positive	strongsubj
senseless	negative	strongsubj
senselessly	negative	strongsubj
sensible	positive	strongsubj
sensibly	positive	strongsubj
sensitively	positive	strongsubj
sensitivity	positive	strongsubj
sentiment	positive	strongsubj
sentimentality	positive	strongsubj
sentimentally	positive	strongsubj
sentiments	positive	strongsubj
serene	positive	strongsubj
serenity	positive	strongsubj
serious	negative	strongsubj
seriously	negative	strongsubj
seriousness	negative	strongsubj
sermonize	negative	strongsubj
servitude	negative	strongsubj
set-up	negative	strongsubj
severe	negative	strongsubj
severely	negative	strongsubj
severity	negative	strongsubj
sexy	positive	strongsubj
shabby	negative	strongsubj
shadow	negative	strongsubj
shady	negative	strongsubj
sham	negative	strongsubj
shambles	negative	strongsubj
shame	negative	strongsubj
shameful	negative	strongsubj
shamefully	negative	strongsubj
shamefulness	negative	strongsubj
shameless	negative	strongsubj
shamelessly	negative	strongsubj
shamelessness	negative	strongsubj
shark	negative	strongsubj
shatter	negative	strongsubj
sheer	negative	strongsubj
shimmer	positive	strongsubj
shimmering	positive	strongsubj
shimmeringly	positive	strongsubj
shiny	positive	strongsubj
shirk	negative	strongsubj
shirker	negative	strongsubj
shiver	negative	strongsubj
shock	negative	strongsubj
shocking	negative	strongsubj
shockingly	negative	strongsubj
shoddy	negative	strongsubj
shortchange	negative	strongsubj
shortcoming	negative	strongsubj
shortcomings	negative	strongsubj
shortsighted	negative	strongsubj
shortsightedness	negative	strongsubj
shrew	negative	strongsubj
shrewd	positive	strongsubj
shrewdly	positive	strongsubj
shrewdness	positive	strongsubj
shriek	negative	strongsubj
shrill	negative	strongsubj
shrilly	negative	strongsubj
shrivel	negative	strongsubj
shroud	negative	strongsubj
shrouded	negative	strongsubj
shun	negative	strongsubj
shunned	negative	strongsubj
shy	negative	strongsubj
shyly	negative	strongsubj
shyness	negative	strongsubj
sickly	negative	strongsubj
sickening	negative	strongsubj
sickeningly	negative	strongsubj
sidetrack	negative	strongsubj
sidetracked	negative	strongsubj
sillily	negative	strongsubj
silly	negative	strongsubj
simmer	negative	strongsubj
simplicity	positive	strongsubj
simplistic	negative	strongsubj
simplistically	negative	strongsubj
sin	negative	strongsubj
sinful	negative	strongsubj
sinfully	negative	strongsubj
sincere	positive	strongsubj
sincerely	positive	strongsubj
sinister	negative	strongsubj
sinisterly	negative	strongsubj
skeletons	negative	strongsubj
skeptical	negative	strongsubj
skeptically	negative	strongsubj
skepticism	negative	strongsubj
skillful	positive	strongsubj
skillfully	positive	strongsubj
skittish	negative	strongsubj
skittishly	negative	strongsubj
skulk	negative	strongsubj
slander	negative	strongsubj
slanderer	negative	strongsubj
slanderous	negative	strongsubj
slanderously	negative	strongsubj
slanders	negative	strongsubj
slap	negative	strongsubj
slashing	negative	strongsubj
slaves	negative	strongsubj
sleazy	negative	strongsubj
slime	negative	strongsubj
sloppy	negative	strongsubj
sloppily	negative	strongsubj
sloth	negative	strongsubj
slothful	negative	strongsubj
slur	negative	strongsubj
sly	negative	strongsubj
smack	negative	strongsubj
smart	positive	strongsubj
smarter	positive	strongsubj
smartest	positive	strongsubj
smartly	positive	strongsubj
smile	positive	strongsubj
smiling	positive	strongsubj
smilingly	positive	strongsubj
smitten	positive	strongsubj
smokescreen	negative	strongsubj
smolder	negative	strongsubj
smoldering	negative	strongsubj
smother	negative	strongsubj
smoulder	negative	strongsubj
smouldering	negative	strongsubj
smug	negative	strongsubj
smugly	negative	strongsubj
smut	negative	strongsubj
smuttier	negative	strongsubj
smuttiest	negative	strongsubj
smutty	negative	strongsubj
sneer	negative	strongsubj
sneering	negative	strongsubj
sneeringly	negative	strongsubj
snub	negative	strongsubj
so-cal	negative	strongsubj
so-called	negative	strongsubj
sob	negative	strongsubj
sober	negative	strongsubj
sobering	negative	strongsubj
sociable	positive	strongsubj
soften	positive	strongsubj
solace	positive	strongsubj
solicitous	positive	strongsubj
solicitously	positive	strongsubj
solicitude	positive	strongsubj
solidarity	positive	strongsubj
soliloquize	neutral	strongsubj
somber	negative	strongsubj
soothe	positive	strongsubj
soothingly	positive	strongsubj
sophisticated	positive	strongsubj
sore	negative	strongsubj
sorely	negative	strongsubj
sorrow	negative	strongsubj
sorrowful	negative	strongsubj
sorrowfully	negative	strongsubj
sorry	negative	strongsubj
spade	negative	strongsubj
spank	negative	strongsubj
sparkle	positive	strongsubj
spectacular	positive	strongsubj
spectacularly	positive	strongsubj
spellbind	positive	strongsubj
spellbinding	positive	strongsubj
spellbindingly	positive	strongsubj
spellbound	positive	strongsubj
spilling	negative	strongsubj
spiritless	negative	strongsubj
spiritual	positive	strongsubj
spite	negative	strongsubj
spiteful	negative	strongsubj
spitefully	negative	strongsubj
spitefulness	negative	strongsubj
splayed-finger	neutral	strongsubj
splendid	positive	strongsubj
splendidly	positive	strongsubj
splendor	positive	strongsubj
spoil	negative	strongsubj
spook	negative	strongsubj
spookier	negative	strongsubj
spookiest	negative	strongsubj
spookily	negative	strongsubj
spooky	negative	strongsubj
spoon-fed	negative	strongsubj
spoon-feed	negative	strongsubj
spoonfed	negative	strongsubj
spotless	positive	strongsubj
sprightly	positive	strongsubj
spur	positive	strongsubj
spurious	negative	strongsubj
spurn	negative	strongsubj
sputter	negative	strongsubj
squabble	negative	strongsubj
squabbling	negative	strongsubj
squander	negative	strongsubj
squarely	positive	strongsubj
squash	negative	strongsubj
squirm	negative	strongsubj
staggering	negative	strongsubj
staggeringly	negative	strongsubj
stagnate	negative	strongsubj
stagnation	negative	strongsubj
staid	negative	strongsubj
stale	negative	strongsubj
stalemate	negative	strongsubj
stammer	negative	strongsubj
standstill	negative	strongsubj
star	positive	strongsubj
stark	negative	strongsubj
starkly	negative	strongsubj
stars	positive	strongsubj
startle	negative	strongsubj
startling	negative	strongsubj
startlingly	negative	strongsubj
stately	positive	strongsubj
statuesque	positive	strongsubj
staunch	positive	strongsubj
staunchly	positive	strongsubj
staunchness	positive	strongsubj
steadfast	positive	strongsubj
steadfastly	positive	strongsubj
steadfastness	positive	strongsubj
stellar	positive	strongsubj
stellarly	positive	strongsubj
stench	negative	strongsubj
stereotype	negative	strongsubj
stereotypical	negative	strongsubj
stereotypically	negative	strongsubj
stern	negative	strongsubj
stew	negative	strongsubj
stifle	negative	strongsubj
stifling	negative	strongsubj
stiflingly	negative	strongsubj
stigma	negative	strongsubj
stigmatize	negative	strongsubj
stimulating	positive	strongsubj
sting	negative	strongsubj
stinging	negative	strongsubj
stingingly	negative	strongsubj
stink	negative	strongsubj
stinking	negative	strongsubj
stir	neutral	strongsubj
stirring	positive	strongsubj
stirringly	positive	strongsubj
stodgy	negative	strongsubj
stooge	negative	strongsubj
stooges	negative	strongsubj
straightforward	positive	strongsubj
strange	negative	strongsubj
strangely	negative	strongsubj
stranger	negative	strongsubj
strangest	negative	strongsubj
stress	negative	strongsubj
stressful	negative	strongsubj
stressfully	negative	strongsubj
stricken	negative	strongsubj
strict	negative	strongsubj
strictly	negative	strongsubj
stride	positive	strongsubj
strident	negative	strongsubj
stridently	negative	strongsubj
strife	negative	strongsubj
striking	positive	strongsubj
strikingly	positive	strongsubj
striving	positive	strongsubj
struggle	negative	strongsubj
strut	negative	strongsubj
stubborn	negative	strongsubj
stubbornly	negative	strongsubj
stubbornness	negative	strongsubj
studious	positive	strongsubj
studiously	positive	strongsubj
stuffy	negative	strongsubj
stunned	positive	strongsubj
stunning	positive	strongsubj
stunningly	positive	strongsubj
stupendous	positive	strongsubj
stupendously	positive	strongsubj
stupid	negative	strongsubj
stupidity	negative	strongsubj
stupidly	negative	strongsubj
stupified	negative	strongsubj
stupify	negative	strongsubj
stupor	negative	strongsubj
sty	negative	strongsubj
stylish	positive	strongsubj
stylishly	positive	strongsubj
suave	positive	strongsubj
subjugate	negative	strongsubj
subjugation	negative	strongsubj
sublime	positive	strongsubj
subservience	negative	strongsubj
subservient	negative	strongsubj
succumb	negative	strongsubj
sucker	negative	strongsubj
sufferer	negative	strongsubj
sufferers	negative	strongsubj
suffering	negative	strongsubj
suffocate	negative	strongsubj
sugar-coat	negative	strongsubj
sugar-coated	negative	strongsubj
sugarcoated	negative	strongsubj
sulk	negative	strongsubj
sullen	negative	strongsubj
sully	negative	strongsubj
sumptuous	positive	strongsubj
sumptuously	positive	strongsubj
sumptuousness	positive	strongsubj
sunder	negative	strongsubj
super	positive	strongsubj
superb	positive	strongsubj
superbly	positive	strongsubj
superficial	negative	strongsubj
superficiality	negative	strongsubj
superficially	negative	strongsubj
superfluous	negative	strongsubj
superiority	negative	strongsubj
superlative	positive	strongsubj
superstition	negative	strongsubj
superstitious	negative	strongsubj
support	positive	strongsubj
supporter	positive	strongsubj
supportive	positive	strongsubj
suppose	neutral	strongsubj
supposing	neutral	strongsubj
supremacy	negative	strongsubj
supreme	positive	strongsubj
supremely	positive	strongsubj
supurb	positive	strongsubj
supurbly	positive	strongsubj
sure	positive	strongsubj
surely	positive	strongsubj
surge	positive	strongsubj
surging	positive	strongsubj
surmise	positive	strongsubj
surmount	positive	strongsubj
surpass	positive	strongsubj
surprise	neutral	strongsubj
surprising	neutral	strongsubj
surprisingly	neutral	strongsubj
suspicions	negative	strongsubj
suspicious	negative	strongsubj
suspiciously	negative	strongsubj
swagger	negative	strongsubj
swamped	negative	strongsubj
swear	negative	strongsubj
sweeping	positive	strongsubj
swindle	negative	strongsubj
swipe	negative	strongsubj
swore	negative	strongsubj
sworn	positive	strongsubj
sympathetic	negative	strongsubj
sympathetically	negative	strongsubj
sympathies	negative	strongsubj
sympathize	negative	strongsubj
sympathy	negative	strongsubj
taboo	negative	strongsubj
tact	positive	strongsubj
taint	negative	strongsubj
tainted	negative	strongsubj
talent	positive	strongsubj
talented	positive	strongsubj
tantalizing	positive	strongsubj
tantalizingly	positive	strongsubj
tantamount	neutral	strongsubj
tantrum	negative	strongsubj
tattered	negative	strongsubj
taunt	negative	strongsubj
taunting	negative	strongsubj
tauntingly	negative	strongsubj
taunts	negative	strongsubj
tawdry	negative	strongsubj
teasingly	negative	strongsubj
tedious	negative	strongsubj
tediously	negative	strongsubj
temerity	negative	strongsubj
temper	negative	strongsubj
tempt	positive	strongsubj
temptation	negative	strongsubj
tempting	positive	strongsubj
temptingly	positive	strongsubj
tenacious	positive	strongsubj
tenaciously	positive	strongsubj
tenacity	positive	strongsubj
terrible	negative	strongsubj
terribleness	negative	strongsubj
terribly	negative	strongsubj
terrific	positive	strongsubj
terrifically	positive	strongsubj
terrified	positive	strongsubj
terrify	positive	strongsubj
terrifying	positive	strongsubj
terrifyingly	positive	strongsubj
terror	negative	strongsubj
terror-genic	negative	strongsubj
terrorize	negative	strongsubj
thank	positive	strongsubj
thankful	positive	strongsubj
thankfully	positive	strongsubj
thankless	negative	strongsubj
theoretize	neutral	strongsubj
therefore	neutral	strongsubj
think	neutral	strongsubj
thinkable	positive	strongsubj
thinking	neutral	strongsubj
thirst	negative	strongsubj
thorny	negative	strongsubj
though	neutral	strongsubj
thoughtful	positive	strongsubj
thoughtfully	positive	strongsubj
thoughtfulness	positive	strongsubj
thoughtless	negative	strongsubj
thoughtlessly	negative	strongsubj
thoughtlessness	negative	strongsubj
thrill	positive	strongsubj
thrilling	positive	strongsubj
thrillingly	positive	strongsubj
thrills	positive	strongsubj
throttle	negative	strongsubj
thus	neutral	strongsubj
thusly	neutral	strongsubj
thwart	negative	strongsubj
tidy	positive	strongsubj
time-honored	positive	strongsubj
timid	negative	strongsubj
timidity	negative	strongsubj
timidly	negative	strongsubj
timidness	negative	strongsubj
tingle	positive	strongsubj
tint	neutral	strongsubj
tired	negative	strongsubj
tiresome	negative	strongsubj
tiring	negative	strongsubj
tiringly	negative	strongsubj
titillating	positive	strongsubj
titillatingly	positive	strongsubj
toast	positive	strongsubj
togetherness	positive	strongsubj
toil	negative	strongsubj
tolerable	positive	strongsubj
tolerably	positive	strongsubj
tolerance	positive	strongsubj
tolerantly	positive	strongsubj
torment	negative	strongsubj
tormented	negative	strongsubj
torrent	negative	strongsubj
torrid	positive	strongsubj
torridly	positive	strongsubj
tortuous	negative	strongsubj
torturous	negative	strongsubj
torturously	negative	strongsubj
touches	neutral	strongsubj
touchy	negative	strongsubj
toughness	negative	strongsubj
traduce	negative	strongsubj
tragic	negative	strongsubj
tragically	negative	strongsubj
traitor	negative	strongsubj
traitorous	negative	strongsubj
traitorously	negative	strongsubj
tramp	negative	strongsubj
trample	negative	strongsubj
tranquil	positive	strongsubj
tranquility	positive	strongsubj
trauma	negative	strongsubj
traumatic	negative	strongsubj
traumatically	negative	strongsubj
traumatize	negative	strongsubj
traumatized	negative	strongsubj
travesties	negative	strongsubj
travesty	negative	strongsubj
treachery	negative	strongsubj
treason	negative	strongsubj
treasonous	negative	strongsubj
treasure	positive	strongsubj
tremendous	positive	strongsubj
tremendously	positive	strongsubj
trendy	positive	strongsubj
trepidation	positive	strongsubj
tribute	positive	strongsubj
trick	negative	strongsubj
tricky	negative	strongsubj
trickery	negative	strongsubj
triumph	positive	strongsubj
triumphal	positive	strongsubj
triumphant	positive	strongsubj
triumphantly	positive	strongsubj
trivial	negative	strongsubj
trivialize	negative	strongsubj
trivially	negative	strongsubj
trouble	negative	strongsubj
troublemaker	negative	strongsubj
troublesome	negative	strongsubj
troublesomely	negative	strongsubj
troubling	negative	strongsubj
troublingly	negative	strongsubj
truculent	positive	strongsubj
truculently	positive	strongsubj
true	positive	strongsubj
truly	positive	strongsubj
trump	positive	strongsubj
trumpet	positive	strongsubj
trusting	positive	strongsubj
trustingly	positive	strongsubj
trustworthiness	positive	strongsubj
trustworthy	positive	strongsubj
truth	positive	strongsubj
truthful	positive	strongsubj
truthfully	positive	strongsubj
truthfulness	positive	strongsubj
turmoil	negative	strongsubj
twinkly	positive	strongsubj
twist	negative	strongsubj
twisted	negative	strongsubj
tyrannical	negative	strongsubj
tyrannically	negative	strongsubj
tyranny	negative	strongsubj
tyrant	negative	strongsubj
ugh	negative	strongsubj
ugliness	negative	strongsubj
ugly	negative	strongsubj
ulterior	negative	strongsubj
ultimate	positive	strongsubj
ultimately	positive	strongsubj
ultimatum	negative	strongsubj
ultimatums	negative	strongsubj
ultra	positive	strongsubj
ultra-hardline	negative	strongsubj
unabashed	positive	strongsubj
unabashedly	positive	strongsubj
unacceptable	negative	strongsubj
unacceptablely	negative	strongsubj
unanimous	positive	strongsubj
unassailable	positive	strongsubj
unattractive	negative	strongsubj
unbearable	negative	strongsubj
unbearablely	negative	strongsubj
unbelievable	negative	strongsubj
unbelievably	negative	strongsubj
unbosom	positive	strongsubj
uncivil	negative	strongsubj
uncivilized	negative	strongsubj
unclean	negative	strongsubj
uncommon	positive	strongsubj
uncommonly	positive	strongsubj
uncompromising	negative	strongsubj
uncompromisingly	negative	strongsubj
unconcerned	positive	strongsubj
unconvincing	negative	strongsubj
unconvincingly	negative	strongsubj
uncouth	negative	strongsubj
undaunted	positive	strongsubj
undependability	negative	strongsubj
undependable	negative	strongsubj
underdog	negative	strongsubj
underestimate	negative	strongsubj
underlings	negative	strongsubj
undermine	negative	strongsubj
understand	positive	strongsubj
understandable	positive	strongsubj
understood	positive	strongsubj
understate	positive	strongsubj
understated	positive	strongsubj
understatedly	positive	strongsubj
undesirable	negative	strongsubj
undignified	negative	strongsubj
undisputable	positive	strongsubj
undisputably	positive	strongsubj
undoubted	positive	strongsubj
undoubtedly	positive	strongsubj
undue	negative	strongsubj
unease	negative	strongsubj
uneasily	negative	strongsubj
uneasiness	negative	strongsubj
uneasy	negative	strongsubj
unequal	negative	strongsubj
unequivocal	positive	strongsubj
unequivocally	positive	strongsubj
unethical	negative	strongsubj
unexpectedly	negative	strongsubj
unfair	negative	strongsubj
unfairly	negative	strongsubj
unfaithful	negative	strongsubj
unfaithfully	negative	strongsubj
unfavorable	negative	strongsubj
unfazed	positive	strongsubj
unfeeling	negative	strongsubj
unfettered	positive	strongsubj
unfit	negative	strongsubj
unforgettable	positive	strongsubj
unfortunate	negative	strongsubj
unfortunately	negative	strongsubj
unfounded	negative	strongsubj
unfriendly	negative	strongsubj
ungrateful	negative	strongsubj
ungovernable	negative	strongsubj
unhappily	negative	strongsubj
unhappiness	negative	strongsubj
unhappy	negative	strongsubj
unilateralism	negative	strongsubj
unimaginable	negative	strongsubj
unimaginably	negative	strongsubj
unimportant	negative	strongsubj
unipolar	negative	strongsubj
unjust	negative	strongsubj
unjustifiable	negative	strongsubj
unjustifiably	negative	strongsubj
unjustly	negative	strongsubj
unkind	negative	strongsubj
unkindly	negative	strongsubj
unlamentable	negative	strongsubj
unlamentably	negative	strongsubj
unleash	negative	strongsubj
unlucky	negative	strongsubj
unnaturally	negative	strongsubj
unnerve	negative	strongsubj
unnerved	negative	strongsubj
unnerving	negative	strongsubj
unnervingly	negative	strongsubj
unorthodox	negative	strongsubj
unorthodoxy	negative	strongsubj
unparalleled	positive	strongsubj
unpleasant	negative	strongsubj
unpleasantries	negative	strongsubj
unpopular	negative	strongsubj
unprecedent	negative	strongsubj
unprecedented	negative	strongsubj
unpretentious	positive	strongsubj
unqualified	negative	strongsubj
unquestionable	positive	strongsubj
unquestionably	positive	strongsubj
unravel	negative	strongsubj
unrealistic	negative	strongsubj
unreasonable	negative	strongsubj
unreasonably	negative	strongsubj
unrelenting	negative	strongsubj
unrelentingly	negative	strongsubj
unreliability	negative	strongsubj
unreliable	negative	strongsubj
unrest	negative	strongsubj
unruly	negative	strongsubj
unsavory	negative	strongsubj
unscrupulous	negative	strongsubj
unscrupulously	negative	strongsubj
unseemly	negative	strongsubj
unselfish	positive	strongsubj
unsettle	negative	strongsubj
unsettling	negative	strongsubj
unsettlingly	negative	strongsubj
unsophisticated	negative	strongsubj
unsound	negative	strongsubj
unspeakable	negative	strongsubj
unspeakablely	negative	strongsubj
unsuspecting	negative	strongsubj
untenable	negative	strongsubj
unthinkable	negative	strongsubj
unthinkably	negative	strongsubj
untimely	negative	strongsubj
untrue	negative	strongsubj
untrustworthy	negative	strongsubj
untruthful	negative	strongsubj
unusually	negative	strongsubj
unwanted	negative	strongsubj
unwarranted	negative	strongsubj
unwelcome	negative	strongsubj
unwieldy	negative	strongsubj
unwilling	negative	strongsubj
unwillingly	negative	strongsubj
unwillingness	negative	strongsubj
unwise	negative	strongsubj
unwisely	negative	strongsubj
unworkable	negative	strongsubj
unworthy	negative	strongsubj
unyielding	negative	strongsubj
upbeat	positive	strongsubj
upbraid	negative	strongsubj
upheaval	negative	strongsubj
upheld	positive	strongsubj
uphold	positive	strongsubj
uplifting	positive	strongsubj
upliftingly	positive	strongsubj
upliftment	positive	strongsubj
uproar	negative	strongsubj
uproarious	negative	strongsubj
uproariously	negative	strongsubj
uproarous	negative	strongsubj
uproarously	negative	strongsubj
upsetting	negative	strongsubj
upsettingly	negative	strongsubj
upside	positive	strongsubj
urge	positive	strongsubj
urgency	negative	strongsubj
usurp	negative	strongsubj
usurper	negative	strongsubj
utmost	positive	strongsubj
utter	negative	strongsubj
utterances	neutral	strongsubj
utterly	negative	strongsubj
uttermost	positive	strongsubj
vagrant	negative	strongsubj
vain	negative	strongsubj
vainly	negative	strongsubj
valiant	positive	strongsubj
valiantly	positive	strongsubj
valor	positive	strongsubj
valuable	positive	strongsubj
vanquish	positive	strongsubj
vehement	negative	strongsubj
vehemently	negative	strongsubj
venerable	positive	strongsubj
venerably	positive	strongsubj
vengeance	negative	strongsubj
vengeful	negative	strongsubj
vengefully	negative	strongsubj
vengefulness	negative	strongsubj
venom	negative	strongsubj
venomous	negative	strongsubj
venomously	negative	strongsubj
vent	negative	strongsubj
veritable	positive	strongsubj
vestiges	negative	strongsubj
veto	negative	strongsubj
vex	negative	strongsubj
vexation	negative	strongsubj
vexing	negative	strongsubj
vexingly	negative	strongsubj
vibrant	positive	strongsubj
vibrantly	positive	strongsubj
vice	negative	strongsubj
vicious	negative	strongsubj
viciously	negative	strongsubj
viciousness	negative	strongsubj
victimize	negative	strongsubj
vie	negative	strongsubj
view	neutral	strongsubj
viewpoints	neutral	strongsubj
views	neutral	strongsubj
vile	negative	strongsubj
vileness	negative	strongsubj
vilify	negative	strongsubj
villainous	negative	strongsubj
villainously	negative	strongsubj
villains	negative	strongsubj
villian	negative	strongsubj
villianous	negative	strongsubj
villianously	negative	strongsubj
villify	negative	strongsubj
vindicate	positive	strongsubj
vindictive	negative	strongsubj
vindictively	negative	strongsubj
vindictiveness	negative	strongsubj
violate	negative	strongsubj
violator	negative	strongsubj
virtue	positive	strongsubj
virtuous	positive	strongsubj
virtuously	positive	strongsubj
virulence	negative	strongsubj
virulent	negative	strongsubj
virulently	negative	strongsubj
virus	negative	strongsubj
visionary	positive	strongsubj
vital	positive	strongsubj
vitality	positive	strongsubj
vivacious	positive	strongsubj
vivid	positive	strongsubj
vociferous	negative	strongsubj
vociferously	negative	strongsubj
vouch	positive	strongsubj
vouchsafe	positive	strongsubj
vow	positive	strongsubj
vulgar	negative	strongsubj
vulnerable	positive	strongsubj
wail	negative	strongsubj
waning	negative	strongsubj
want	positive	strongsubj
wanton	negative	strongsubj
war-like	negative	strongsubj
warlike	negative	strongsubj
warmhearted	positive	strongsubj
warmly	positive	strongsubj
wary	negative	strongsubj
warily	negative	strongsubj
wariness	negative	strongsubj
watchdog	negative	strongsubj
wayward	negative	strongsubj
weaken	negative	strongsubj
weakening	negative	strongsubj
weakness	negative	strongsubj
weaknesses	negative	strongsubj
weariness	negative	strongsubj
wearisome	negative	strongsubj
weary	negative	strongsubj
wee	negative	strongsubj
weird	negative	strongsubj
weirdly	negative	strongsubj
welcome	positive	strongsubj
well-being	positive	strongsubj
well-connected	positive	strongsubj
well-informed	positive	strongsubj
well-intentioned	positive	strongsubj
well-managed	positive	strongsubj
well-received	positive	strongsubj
well-regarded	positive	strongsubj
well-run	positive	strongsubj
well-wishers	positive	strongsubj
wellbeing	positive	strongsubj
wheedle	negative	strongsubj
whimper	negative	strongsubj
whimsical	positive	strongsubj
whine	negative	strongsubj
whips	negative	strongsubj
wholeheartedly	positive	strongsubj
wholesome	positive	strongsubj
wicked	negative	strongsubj
wickedly	negative	strongsubj
wickedness	negative	strongsubj
wiles	negative	strongsubj
will	positive	strongsubj
willful	positive	strongsubj
willfully	positive	strongsubj
willing	positive	strongsubj
willingness	positive	strongsubj
wilt	negative	strongsubj
wily	negative	strongsubj
wince	negative	strongsubj
wink	positive	strongsubj
winnable	positive	strongsubj
winners	positive	strongsubj
wisdom	positive	strongsubj
wise	positive	strongsubj
wisely	positive	strongsubj
wish	positive	strongsubj
wishes	positive	strongsubj
wishing	positive	strongsubj
witty	positive	strongsubj
woe	negative	strongsubj
woebegone	negative	strongsubj
woeful	negative	strongsubj
woefully	negative	strongsubj
wonder	positive	strongsubj
wonderful	positive	strongsubj
wonderfully	positive	strongsubj
wonderous	positive	strongsubj
wonderously	positive	strongsubj
wondrous	positive	strongsubj
woo	positive	strongsubj
workable	positive	strongsubj
world-famous	positive	strongsubj
worried	negative	strongsubj
worriedly	negative	strongsubj
worrier	negative	strongsubj
worries	negative	strongsubj
worrisome	negative	strongsubj
worry	negative	strongsubj
worrying	negative	strongsubj
worryingly	negative	strongsubj
worse	negative	strongsubj
worsen	negative	strongsubj
worsening	negative	strongsubj
worst	negative	strongsubj
worth	positive	strongsubj
worth-while	positive	strongsubj
worthiness	positive	strongsubj
worthless	negative	strongsubj
worthlessly	negative	strongsubj
worthlessness	negative	strongsubj
worthwhile	positive	strongsubj
worthy	positive	strongsubj
wound	negative	strongsubj
wow	positive	strongsubj
wrangle	negative	strongsubj
wrath	negative	strongsubj
wrest	negative	strongsubj
wretch	negative	strongsubj
wretched	negative	strongsubj
wretchedly	negative	strongsubj
wretchedness	negative	strongsubj
wrongly	negative	strongsubj
wry	positive	strongsubj
yawn	negative	strongsubj
yeah	neutral	strongsubj
yearn	positive	strongsubj
yearning	positive	strongsubj
yearningly	positive	strongsubj
yelp	negative	strongsubj
yep	positive	strongsubj
yes	positive	strongsubj
zeal	positive	strongsubj
zealot	negative	strongsubj
zealous	negative	strongsubj
zealously	negative	strongsubj
zenith	positive	strongsubj
zest	positive	strongsubj